未派单	4a绕行事件状态值
已派单	4a绕行事件状态值
已审核	4a绕行事件状态值
未审核	4a绕行事件状态值
已处置	4a绕行事件状态值
未处置	4a绕行事件状态值
平台自建白名单	4a绕行处置方式
误报	4a绕行处置方式
待处置	4a绕行处置状态
已处置	4a绕行处置状态
主机登录日志	4A绕行数据来源
数据流转流量	4A绕行数据来源
堡垒机操作日志	4A绕行数据来源
4A操作日志	4A绕行日志类型
4A金库日志	4A绕行日志类型
认证服务器日志	4A绕行日志类型
主机登录日志	4A绕行日志类型
堡垒机绕行行为	4a绕行类型
终端直连行为	4a绕行类型
资源内越权行为	4a绕行类型
资源外越权行为	4a绕行类型
主机互访绕行行为	4a绕行类型
金库绕行行为	4a绕行类型
应用绕行行为	4a绕行类型
疑似金库绕行行为	4a绕行类型
Linux	4a绕行资源类型
windows	4a绕行资源类型
oracle	4a绕行资源类型
DB2	4a绕行资源类型
mysql	4a绕行资源类型
SQLSERVER	4a绕行资源类型
SYSBASE	4a绕行资源类型
GBASE	4a绕行资源类型
其他	4a绕行资源类型
5G智能采矿系统	5G行业应用系统
5G智慧港口系统	5G行业应用系统
5G智慧电力系统	5G行业应用系统
5G工业互联网系统	5G行业应用系统
5G智慧物流系统	5G行业应用系统
5G智慧医疗系统	5G行业应用系统
5G文化旅游系统	5G行业应用系统
5G智慧农业系统	5G行业应用系统
5G智慧教育系统	5G行业应用系统
5G融合媒体系统	5G行业应用系统
5G无人机巡检系统	5G行业应用系统
5G智慧工厂系统	5G行业应用系统
5G智慧交通系统	5G行业应用系统
5G车联网系统	5G行业应用系统
其它5G行业应用系统	5G行业应用系统
自动溯源	api溯源方式
手动溯源	api溯源方式
未溯源	api溯源状态
已溯源	api溯源状态
未备案	api稽核状态
已备案	api稽核状态
全流量发现	api资产来源
EOP发现	api资产来源
API同步	api资产来源
CRM系统	B域业务平台
计费系统	B域业务平台
账务系统	B域业务平台
BOSS系统	B域业务平台
经营分析系统	B域业务平台
无纸化系统	B域业务平台
营收稽核系统	B域业务平台
大数据分析平台	B域业务平台
其它B域系统	B域业务平台
正常	DLP-健康状态
异常	DLP-健康状态
input-str	IP
input-str	IP
input-str	IP
input-str	IP
input-str	IP
input-str	IP
IPV4	IP地址类型
IPV6	IP地址类型
OA系统	M域支撑系统
供应链系统	M域支撑系统
计划建设平台	M域支撑系统
项目交付管理系统	M域支撑系统
台账系统	M域支撑系统
管理信息系统（MIS）	M域支撑系统
其它M域系统	M域支撑系统
MySQL	oceanbase连接模式
Oracle	oceanbase连接模式
短信中心	O域业务平台
彩信中心（MMSC）/5G新消息	O域业务平台
行业网关	O域业务平台
短信网关	O域业务平台
LTE上网日志留存系统	O域业务平台
LBS	O域业务平台
MISC（DSMP）	O域业务平台
中国移动ICP/IP信息备案管理系统	O域业务平台
其它O域系统	O域业务平台
网管系统（性能管理系统）	O域支撑系统
网管系统（资源管理系统）	O域支撑系统
网络客服管理系统	O域支撑系统
VOLTE/5G信令监测系统	O域支撑系统
7号信令监测系统	O域支撑系统
IDRA-OMC国际漫游分析系统	O域支撑系统
上网日志留存系统	O域支撑系统
垃圾短彩信管控系统	O域支撑系统
统一DPI系统	O域支撑系统
集中日志查询平台	O域支撑系统
集中日志上报网关	O域支撑系统
端局（MSC）	O域通信系统
HSS/HLR/AUSF/UDM	O域通信系统
WAP网关	O域通信系统
关口局	O域通信系统
hive	trino支持的连接器
kudu	trino支持的连接器
redis	trino支持的连接器
elasticsearch	trino支持的连接器
postgresql	trino支持的连接器
iceberg	trino支持的连接器
mysql	trino支持的连接器
oracle	trino支持的连接器
clickhouse	trino支持的连接器
否	trino数据库是否ssl连接
是	trino数据库是否ssl连接
ueba-业务风险	ueba风险来源
ueba-设备风险	ueba风险来源
大屏派单	ueba风险派单方向
态势派单	ueba风险派单方向
未溯源	ueba风险溯源状态
已溯源	ueba风险溯源状态
自动溯源	ueba风险溯源类型
手动溯源	ueba风险溯源类型
新建	web监测任务状态
运行中	web监测任务状态
结束	web监测任务状态
数据库原始日志	上传文件类型
全量数据库表结构文件	上传文件类型
新增	上报操作类型
编辑	上报操作类型
删除	上报操作类型
自动	上报方式
手动	上报方式
未上报	上报状态
上报失败	上报状态
上报成功	上报状态
上报暂停	上报状态
数据加密	上报策略类型
数据脱敏	上报策略类型
数字水印	上报策略类型
资产组	上报类型
资产	上报类型
行业规范	上报类型
数据模型	上报类型
数据分类	上报类型
数据分类关联数据模型	上报类型
数据分级	上报类型
敏感数据库shcema	上报类型
敏感数据库表	上报类型
敏感数据字段	上报类型
敏感文件	上报类型
数据安全策略	上报类型
风险事件	上报类型
未上报	上报记录状态
上报中	上报记录状态
上报成功	上报记录状态
上报失败	上报记录状态
归档成功	上报记录状态
归档失败	上报记录状态
日增量	上报频次
周增量	上报频次
月全量	上报频次
全量	上报频次
一般数据	上海异常防护预警数据级别
重要数据	上海异常防护预警数据级别
核心数据	上海异常防护预警数据级别
已创建	上海涉敏-下发作业状态
填报中	上海涉敏-下发作业状态
已完成	上海涉敏-下发作业状态
审核中	上海涉敏-下发作业状态
平台自定义	上海涉敏-作业类型
smp变更	上海涉敏-作业类型
月度	上海涉敏-作业类型
已填报	上海涉敏-填报作业状态
填报中	上海涉敏-填报作业状态
已驳回	上海涉敏-填报作业状态
已完成	上海涉敏-填报作业状态
未下发	下发状态
已下发	下发状态
Y	与930同步设置
5	与930同步设置
23	与930同步设置
59	与930同步设置
/home/idss/sync/tmp	与930同步设置
/home/idss/sync/zip	与930同步设置
是-客户授权	业务操作是否涉及外部授权
是-工单授权	业务操作是否涉及外部授权
不涉及	业务操作是否涉及外部授权
文件操作	业务模块
用户管理	业务模块
角色管理	业务模块
部门管理	业务模块
菜单管理	业务模块
租户管理	业务模块
登陆策略配置	业务模块
密码策略配置	业务模块
系统信息配置	业务模块
系统字典配置	业务模块
站内信	业务模块
传输中心	业务模块
操作日志	业务模块
登陆	业务模块
对外接口	业务模块
数据资产管理-未知资产发现	业务模块
数据安全运营-管控措施推荐	业务模块
数据资产视图	业务模块
数据资产及敏感数据分布	业务模块
数据资产管理	业务模块
数据资产管理-业务系统	业务模块
数据资产管理-数据资产	业务模块
数据资产管理-应用情况	业务模块
数据资产管理-对外接口	业务模块
数据资产管理-数据采集	业务模块
数据资产管理-涉敏场景	业务模块
数据资产管理-涉敏人员	业务模块
资产变更管控	业务模块
资产下线管控	业务模块
资产下线清单	业务模块
资产下线策略	业务模块
敏感数据发现-任务管理"	业务模块
敏感数据发现-核查管理	业务模块
策略管理-管理策略	业务模块
策略管理-业务策略	业务模块
策略操作-管理策略（分类分级策略）	业务模块
策略操作-业务策略（分类分级策略）	业务模块
策略操作-能力策略（分类分级策略）	业务模块
敏感识别白名单	业务模块
未知资产发现白名单	业务模块
数据流转探针管理	业务模块
安全风险（数据流量监控操作）	业务模块
安全风险	业务模块
传输中心	业务模块
操作日志	业务模块
登录日志	业务模块
4A绕行白名单	业务模块
脱敏验证	业务模块
平台堡垒机管理	业务模块
流量监测范围策略	业务模块
流量监测结果	业务模块
4A绕行管理	业务模块
分类分级清单	业务模块
数据溯源分析	业务模块
数据资产扫描核查统计	业务模块
表清单	业务模块
SMC同步表清单	业务模块
绕行金库策略	业务模块
IT领域数据安全集中管控	业务模块
建议反馈	业务模块
数据资产上报	业务模块
敏感数据识别上报	业务模块
数据事件上报	业务模块
数据策略上报	业务模块
拨测上报	业务模块
第三方能力跳转	业务模块
合规性管理	业务模块
指标集中化管理	业务模块
省端共性需求	业务模块
封堵解锁处置	业务模块
未知资产发现	业务模块
网管上报	业务模块
分类分级清单上报	业务模块
重要数据清单上报	业务模块
策略上报	业务模块
安全事件上报	业务模块
数据识别规则上报	业务模块
接口资产上报	业务模块
数据安全任务上报	业务模块
问题处置和跟踪上报	业务模块
能力上报	业务模块
数据分级管控策略	业务模块
大数据动态运维	业务模块
数据权限管理	业务模块
API鉴权日志	业务模块
数据台账	业务模块
生命周期标识	业务模块
业务系统管理	业务模块
风险预警	业务模块
性能概览查看	业务模块
自动扫描任务管理	业务模块
部门分组设置	业务模块
系统分组设置	业务模块
分类模板管理	业务模块
数据类型管理	业务模块
分类分级任务	业务模块
智能打标任务	业务模块
报告列表	业务模块
任务计划管理	业务模块
样本查看	业务模块
文件目录	业务模块
数据目录	业务模块
分类分级清单	业务模块
重要数据清单	业务模块
资源清单	业务模块
合规检查任务管理	业务模块
合规检查项目管理	业务模块
系统菜单管理	业务模块
系统角色管理	业务模块
用户管理	业务模块
数据字典管理	业务模块
发现模板管理	业务模块
数据特征管理	业务模块
审计信息设置	业务模块
数据发现任务管理	业务模块
后台配置	业务模块
安全配置	业务模块
文件资源管理	业务模块
文件资源数据发现任务管理	业务模块
扫描处理器管理	业务模块
插件版本	业务模块
数据资源管理	业务模块
应用资产	业务模块
数据库资产	业务模块
邮件资产	业务模块
文件资产	业务模块
其它库资产	业务模块
风险主体-接口	业务模块
风险主体-IP	业务模块
风险主体-账号	业务模块
风险主体-资产	业务模块
风险事件	业务模块
风险策略	业务模块
接口管理	业务模块
账号管理	业务模块
源ip管理	业务模块
业务系统	业务模块
业务用户	业务模块
风险白名单-接口	业务模块
风险白名单-源IP	业务模块
风险白名单-账号	业务模块
风险白名单-资产	业务模块
风险策略白名单-接口	业务模块
风险策略白名单-源IP	业务模块
风险策略白名单-账号	业务模块
风险策略白名单-资产	业务模块
监测模式	业务模块
数据字典	业务模块
风险事件-非涉敏访问	业务模块
风险事件-详情	业务模块
风险事件-详情	业务模块
流转监测	业务模块
系统流转	业务模块
源ip资产	业务模块
分类分级	业务模块
分类分级-接口	业务模块
分类分级-数据库表	业务模块
脱敏取消密钥	业务模块
脱敏取消密钥	业务模块
openapi	业务模块
运营报告	业务模块
数据字典	业务模块
大屏统计	业务模块
溯源	业务模块
agent	业务模块
基线	业务模块
第三方	业务模块
工单创建	业务模块
业务系统信息填报清单	业务模块
数据资产信息填报清单	业务模块
涉敏操作日志	业务模块
涉敏资产表清单	业务模块
运营工作台	业务模块
涉敏场景	业务模块
无数据资产业务系统白名单上报	业务模块
核心数据清单	业务模块
数据安全分析预警	业务模块
数据安全分析预警处置流程	业务模块
未完成	业务策略完成状态
已完成	业务策略完成状态
未创建	业务策略执行状态
未执行	业务策略执行状态
已执行	业务策略执行状态
123	业务系统
无	主管部门条线
市场条线	主管部门条线
客服条线	主管部门条线
云网条线	主管部门条线
政企条线	主管部门条线
渠道条线	主管部门条线
网信安条线	主管部门条线
其他	主管部门条线
运维事件	事件分类
运营事件	事件分类
运维需要	事件原因
业务需要	事件原因
异常访问	事件原因
其他	事件原因
未处理	事件处理状态
已处理	事件处理状态
帐号异常	事件大类
异常访问	事件大类
暴力破解	事件大类
高风险行为	事件大类
接口访问异常	事件大类
敏感数据异常操作	事件大类
画像偏离	事件大类
漏扫	事件大类
弱口令	事件大类
配置核查	事件大类
其他	事件大类
 是	事件核查是否设置敏感
 否	事件核查是否设置敏感
数据采集过程监测	事件监测事件分类
数据传输过程监测	事件监测事件分类
数据存储过程监测	事件监测事件分类
数据处理过程监测	事件监测事件分类
数据交换过程监测	事件监测事件分类
对外接口数据访问量异常波动监测	事件监测策略名称
对外接口中未脱敏数据监测	事件监测策略名称
未报备对外接口监测	事件监测策略名称
生产运维异常操作预警	事件监测策略名称
生产运维越权访问预警	事件监测策略名称
生产运维访问敏感数据预警	事件监测策略名称
生产运维访问未备案预警	事件监测策略名称
对外接口高频访问	事件监测筛选器
对外接口敏感数据	事件监测筛选器
对外接口未备案	事件监测筛选器
生产运维异常操作	事件监测筛选器
生产运维越权访问	事件监测筛选器
生产运维访问敏感数据	事件监测筛选器
生产运维访问未备案	事件监测筛选器
高	事件等级
中	事件等级
低	事件等级
低危	事件等级
中危	事件等级
高危	事件等级
极低危	事件等级
信息	事件管理数据级别
低	事件管理数据级别
中	事件管理数据级别
高	事件管理数据级别
低	事件管理数据级别
中	事件管理数据级别
高	事件管理数据级别
未审核	事件管理状态
误报	事件管理状态
已审核	事件管理状态
敏感数据明文传输监测	事件类型
对外接口高频访问	事件类型
对外接口敏感数据	事件类型
对外接口未备案	事件类型
运维异常操作	事件类型
对外接口传输业务内容合规性	事件类型
敏感数据明文存储或传输	事件类型
未授权调用数据共享接口	事件类型
数据泄露	事件类型
数据完整性非法篡改	事件类型
数据操作行为基线偏离	事件类型
敏感数据未纳入金库管控	事件类型
数据共享接口未经备案	事件类型
数据所在资产脆弱性事件	事件类型
其他	事件类型
接口防御预警	事件类型
对外接口未授权分析	事件类型
未知数据资产	事件类型
敏感数据流转监控识别	事件类型
对外接口高频访问	事件类型
对外接口敏感数据	事件类型
对外接口未备案	事件类型
运维异常操作	事件类型
运维越权访问	事件类型
运维访问未备案	事件类型
对外接口未知报文	事件类型
对外接口未授权	事件类型
特大	事件级别
重大	事件级别
较大	事件级别
一般	事件级别
特大	事件级别
重大	事件级别
较大	事件级别
一般	事件级别
ASCG	事件组件具体类型
ASCG_API	事件组件具体类型
堡垒机_PORTAL	事件组件具体类型
堡垒机	事件组件具体类型
DBMASKING	事件组件具体类型
DLP控制中心	事件组件具体类型
数据库水印	事件组件具体类型
数据库加密	事件组件具体类型
数据库审计	事件组件具体类型
数据库防火墙	事件组件具体类型
文件管控	事件组件具体类型
终端DLP	事件组件具体类型
存储DLP	事件组件具体类型
SSB	事件组件具体类型
画像偏离	事件组件具体类型
次要	事件风险值
一般	事件风险值
严重	事件风险值
紧急	事件风险值
次要	事件风险等级
一般	事件风险等级
严重	事件风险等级
紧急	事件风险等级
内部共享	交换阶段
对外提供个人信息	交换阶段
跨境提供	交换阶段
数据共享规范管理及审批	交换阶段
数据开放共享溯源	交换阶段
开放共享接口管理	交换阶段
接收者资质审核	交换阶段
个人敏感信息去标识化	交换阶段
个人信息开放共享安全保护	交换阶段
资产发现	代办中心任务类型
立即	任务执行方式
指定	任务执行方式
周期	任务执行方式
周期	任务执行方式
周期	任务执行方式
未执行	任务执行状态
 排队中	任务执行状态
 执行中	任务执行状态
 已完成	任务执行状态
 停止	任务执行状态
 失败	任务执行状态
暂停	任务执行状态
结果处理中	任务执行状态
待核查	任务核查状态
已保存	任务核查状态
已完成	任务核查状态
进行中	任务核查状态
合规评估流程	任务流程
待下发	任务状态
已下发	任务状态
进行中	任务状态
已完成	任务状态
已归档	任务状态
已办	任务状态
待办	任务状态
办理中	任务状态
核查提醒	任务类型
业务策略执行	任务类型
防护能力策略审批	任务类型
分类分级能力策略审批	任务类型
管理策略审批	任务类型
能力策略执行	任务类型
涉敏资产高频访问	任务类型
敏感数据明文传输监测	任务类型
对外接口高频访问	任务类型
对外接口敏感数据	任务类型
对外接口未备案	任务类型
资产发现清单	任务类型
上报任务	任务类型
同步任务	任务类型
数据完整性保护	传输-数据防护能力
接口管控	传输-数据防护能力
传输加密	传输-数据防护能力
流量监测	传输-数据防护能力
流转监测	传输中心任务源
应用资产	传输中心任务源
数据库资产	传输中心任务源
邮件资产	传输中心任务源
文件资产	传输中心任务源
其它资产	传输中心任务源
风险主体-接口	传输中心任务源
风险主体-IP	传输中心任务源
风险主体-账号	传输中心任务源
风险主体-资产	传输中心任务源
风险事件	传输中心任务源
风险策略	传输中心任务源
接口管理	传输中心任务源
账号管理	传输中心任务源
业务系统	传输中心任务源
业务用户	传输中心任务源
风险白名单-接口	传输中心任务源
风险白名单-源IP	传输中心任务源
风险白名单-账号	传输中心任务源
风险白名单-资产	传输中心任务源
风险策略白名单-接口	传输中心任务源
风险策略白名单-源IP	传输中心任务源
风险策略白名单-账号	传输中心任务源
风险策略白名单-资产	传输中心任务源
监测模式	传输中心任务源
数据字典	传输中心任务源
风险事件-详情	传输中心任务源
流转测绘	传输中心任务源
流转监测详情	传输中心任务源
agent下载	传输中心任务源
风险事件-非涉敏访问	传输中心任务源
业务部门管理	传输中心任务源
分类分级-接口	传输中心任务源
分类分级-数据库表	传输中心任务源
源ip资产	传输中心任务源
未知资产	传输中心任务源
流转测绘地图	传输中心任务源
未知资产	传输中心任务源
源ip访问资源	传输中心任务源
流转白名单	传输中心任务源
数据上报业务系统	传输中心任务源
数据上报资产	传输中心任务源
涉敏资产表清单	传输中心任务源
数据分类分级清单	传输中心任务源
重要数据清单	传输中心任务源
数据安全策略	传输中心任务源
数据安全事件	传输中心任务源
数据识别特征	传输中心任务源
数据共享接口	传输中心任务源
数据安全任务执行情况	传输中心任务源
数据安全问题处置与跟踪情况	传输中心任务源
数据安全防护能力建设情况	传输中心任务源
核心数据清单	传输中心任务源
涉敏系统清单	传输中心任务源
涉敏人员清单	传输中心任务源
数据权限清单	传输中心任务源
数据库原始日志	传输中心任务源
风险事件预警导出	传输中心任务源
溯源分析报告	传输中心任务源
网段配置	传输中心任务源
企业清单管理导入	传输中心任务源
分类分级填报清单	传输中心任务源
系统类型映射配置	传输中心任务源
一般数据资产清单	传输中心任务源
重要核心数据清单	传输中心任务源
数据安全风险及处置情况	传输中心任务源
数据对外合作情况	传输中心任务源
数据安全防护能力建设情况	传输中心任务源
无数据资产业务系统白名单上报	传输中心任务源
分类分级任务资产导出	传输中心任务源
风险策略白名单导入	传输中心任务源
风险策略白名单导出	传输中心任务源
风险事件预警导出	传输中心任务源
电信态势上报-上报记录	传输中心任务源
预警处置流程导出	传输中心任务源
网络数据安全责任矩阵清单	传输中心任务源
合规评估备案	传输中心任务源
系统接入4A审计预警	传输中心任务源
日志涉敏审计预警	传输中心任务源
数据识别规则知识库	传输中心任务源
数据安全事件处置知识库	传输中心任务源
SMP业务系统同步对比结果	传输中心任务源
SMP数据库资源同步对比结果	传输中心任务源
SMP未知资产同步对比结果	传输中心任务源
关键岗位责任人管理	传输中心任务源
关键岗位责任人管理统计视图	传输中心任务源
4A绕行管理	传输中心任务源
堡垒机管理	传输中心任务源
核查统计	传输中心任务源
事件视图	传输中心任务源
脱敏策略	传输中心任务源
涉敏场景	传输中心任务源
能力策略	传输中心任务源
管理策略	传输中心任务源
数据资产	传输中心任务源
对外接口	传输中心任务源
应用情况	传输中心任务源
涉敏人员	传输中心任务源
数据资产重要数据清单	传输中心任务源
数据资产表清单	传输中心任务源
资产清单无归属资产	传输中心任务源
资产分类分级清单	传输中心任务源
敏感数据发现任务	传输中心任务源
分类分级核查	传输中心任务源
核查管理	传输中心任务源
分类分级离线任务	传输中心任务源
未知资产	传输中心任务源
业务系统	传输中心任务源
对外接口报备	传输中心任务源
金库对比	传输中心任务源
敏感数据字典	传输中心任务源
数据资产上报	传输中心任务源
敏感数据识别上报	传输中心任务源
数据事件上报	传输中心任务源
拨测上报	传输中心任务源
数据策略上报	传输中心任务源
解封账号	传输中心任务源
分类分级清单上报	传输中心任务源
问题处置和跟踪上报	传输中心任务源
重要数据清单上报	传输中心任务源
接口资产上报	传输中心任务源
能力上报	传输中心任务源
数据识别规则上报	传输中心任务源
安全事件上报	传输中心任务源
数据安全任务上报	传输中心任务源
策略上报	传输中心任务源
涉敏数据稽核	传输中心任务源
涉敏数据分布视图	传输中心任务源
涉敏数据分布明细视图	传输中心任务源
涉敏数据资源清单	传输中心任务源
主机/终端资产认领管理	传输中心任务源
终端/主机资源备案管理	传输中心任务源
涉敏终端/主机信息测绘	传输中心任务源
终端场景风险监测	传输中心任务源
数据安全策略管理	传输中心任务源
安全合规模板管理	传输中心任务源
安全合规任务管理	传输中心任务源
安全合规工单管理	传输中心任务源
涉敏场景管理	传输中心任务源
合规性管理	传输中心任务源
数据分级管控策略	传输中心任务源
安全合规管理	传输中心任务源
安全合规标准	传输中心任务源
操作日志	传输中心任务源
报表	传输中心任务源
业务系统	传输中心任务源
网管上报数据清单操作日志	传输中心任务源
敏感表清单	传输中心任务源
信息系统信息	传输中心任务源
信息系统数据安全台账	传输中心任务源
数据库资产信息	传输中心任务源
文件系统资产信息	传输中心任务源
API资产台账	传输中心任务源
API安全风险排查及整改信息	传输中心任务源
API资产访问情况	传输中心任务源
敏感数据表信息	传输中心任务源
敏感数据字段信息	传输中心任务源
敏感文件信息	传输中心任务源
风险事件信息	传输中心任务源
数据责任人	传输中心任务源
合规稽核问题处置	传输中心任务源
定级备案清单	传输中心任务源
数据资产自动识别预警	传输中心任务源
全流量资产	传输中心任务源
应用资源涉敏场景清单	传输中心任务源
涉敏人员清单	传输中心任务源
涉敏金库场景清单	传输中心任务源
系统资源涉敏场景清单	传输中心任务源
资产清单导出	传输中心任务源
分类模板导入	传输中心任务源
文件资产导入	传输中心任务源
数据库资产导入	传输中心任务源
数据库资产导出	传输中心任务源
文件资产导出	传输中心任务源
重要数据清单导出	传输中心任务源
分类分级清单导出	传输中心任务源
文件目录导出	传输中心任务源
数据目录导出	传输中心任务源
发现任务结果导出	传输中心任务源
合规检查项目导出	传输中心任务源
合规检查项目导入	传输中心任务源
分类分级任务预览资产表导出	传输中心任务源
分类模板导出备份	传输中心任务源
结构化核查导出	传输中心任务源
非结构化核查导出	传输中心任务源
结构化核查导入	传输中心任务源
非结构化核查导入	传输中心任务源
离线任务导入	传输中心任务源
核心数据清单导出	传输中心任务源
失败	传输中心任务状态
成功	传输中心任务状态
进行中	传输中心任务状态
第1级	传输数据敏感级别
第2级	传输数据敏感级别
第3级	传输数据敏感级别
第4级	传输数据敏感级别
传输通道	传输阶段
数据传输安全管理	传输阶段
数据加密传输	传输阶段
传输接口安全管理	传输阶段
跨境传输安全评估	传输阶段
tyuty	低敏感
石油、煤炭及其他燃料加工业	作业填报列表任务下发
化学原料和化学制品制造业（除日用化学品制造）	作业填报列表任务下发
数据分类分级扫描稽核	作业管理类型
数据资产认领稽核	作业管理类型
静态脱敏验证作业	作业管理类型
数据访问控制	使用加工-数据防护能力
数据导入导出管控	使用加工-数据防护能力
数据防泄漏	使用加工-数据防护能力
数据脱敏	使用加工-数据防护能力
数据水印	使用加工-数据防护能力
访问和操作行为审计	使用加工-数据防护能力
风险监测	使用加工-数据防护能力
长期	保存期限
短期	保存期限
月增量	信安上报频次
月全量	信安上报频次
季全量	信安上报频次
一般数据资产清单	信安数据上报清单类型
重要（核心）数据清单	信安数据上报清单类型
数据安全风险及处置情况	信安数据上报清单类型
数据对外合作情况	信安数据上报清单类型
数据安全防护能力建设情况	信安数据上报清单类型
政府	信安数据接收方所属单位类型
事业单位	信安数据接收方所属单位类型
企业	信安数据接收方所属单位类型
个人	信安数据接收方所属单位类型
其他	信安数据接收方所属单位类型
第1级	信安风险处置数据级别
第2级	信安风险处置数据级别
第3级	信安风险处置数据级别
第4级	信安风险处置数据级别
重要数据	信安风险处置数据级别
核心数据	信安风险处置数据级别
未定级	信息系统定级
一级	信息系统定级
二级	信息系统定级
三级	信息系统定级
四级	信息系统定级
五级	信息系统定级
SFTP	元数据文件
MYSQL	元数据资产
GaussDB	元数据资产
待处理	入网流程状态
待审核	入网流程状态
驳回	入网流程状态
已归档	入网流程状态
未备案	全流量资产备案结果
已备案	全流量资产备案结果
否	全流量资产白名单
是	全流量资产白名单
数据完整性保护	公开-数据防护能力
数据脱敏	公开-数据防护能力
公网	公私网标签
私网	公私网标签
接口管控	共享-数据防护能力
数据脱敏	共享-数据防护能力
隐私计算	共享-数据防护能力
数据溯源	共享-数据防护能力
精确匹配	关键字识别方式
前缀匹配	关键字识别方式
后缀匹配	关键字识别方式
模糊匹配	关键字识别方式
①承载重要数据和核心数据的系统，其维护人员	关键岗位责任人角色
②具有对10万条及以上一般数据/1万条及以上用户个人信息/1000条及以上特定人员信息进行批量修改、导出、删除操作权限的人员	关键岗位责任人角色
③负责对①②中相关操作进行审批和定期安全审计的人员	关键岗位责任人角色
④各系统数据加解密密钥保管人员	关键岗位责任人角色
⑤网信安部门或业务管理部门认定的其它人员，应纳入数据安全关键岗位人员	关键岗位责任人角色
是	关键系统
否	关键系统
其他系统	其他
摩托车制造	其他运输设备
助动车制造	其他运输设备
非公路休闲车成委配件制造	其他运输设备
潜水救捞及其他未列明运输设备制造	其他运输设备
一般数据	分类任务模板适用范围
重要数据	分类任务模板适用范围
核心数据	分类任务模板适用范围
文件类非结构化数据	分类分级清单上报-数据类型
数据库类结构化数据	分类分级清单上报-数据类型
用户相关信息	分类分级类型
企业自身相关数据	分类分级类型
1-1-1-1 自然人身份标识	分类规范
1-1-1-2 网络身份标识	分类规范
1-1-1-3 用户基本资料	分类规范
1-1-1-4 实体身份证明	分类规范
1-1-1-5 用户私密资料	分类规范
1-1-2-1 用户密码及关联信息	分类规范
1-2-1-1 服务内容数据	分类规范
1-2-1-2 联系人信息	分类规范
1-3-1-1 业务订购关系	分类规范
1-3-1-2 服务记录和日志	分类规范
1-3-1-3消费信息和账单	分类规范
1-3-1-4 位置数据	分类规范
1-3-1-5 违规记录数据	分类规范
1-3-2-1 终端设备标识	分类规范
1-3-2-2 终端设备资料	分类规范
2-1-1-1 网络规划类	分类规范
2-1-1-2 投资计划类	分类规范
2-1-1-3 项目管理类	分类规范
2-1-2-2 物理资源（传输资源类数据）	分类规范
2-1-2-3 逻辑资源（承载网资源）	分类规范
2-1-2-4 业务资源（核心网资源）	分类规范
2-1-2-5 接入网资源	分类规范
2-1-2-6 IT 系统资源	分类规范
2-1-2-7 云资源	分类规范
2-1-3-1 信令	分类规范
2-1-3-2 路由信息	分类规范
2-1-3-3 网段、网址、VLAN 划分	分类规范
2-1-3-4 设备监测、告警	分类规范
2-1-3-5 信令监测	分类规范
2-1-3-6 流量监测	分类规范
2-1-3-7 运维日志	分类规范
2-1-3-8 运维系统账号密码等	分类规范
2-1-3-9 系统运行状况统计分析	分类规范
2-1-4-1 安全审计记录	分类规范
2-1-4-2 网络安全应急预案	分类规范
2-1-4-3 违法有害信息监测	分类规范
2-1-4-4 核心区域监控	分类规范
2-1-4-5 网络威胁数据	分类规范
2-2-1-1 产品信息	分类规范
2-2-1-2 渠道信息	分类规范
2-2-1-3 客户服务信息	分类规范
2-2-1-4 营销信息	分类规范
2-3-1-1 发展战略	分类规范
2-3-1-2 重大决策与重要会议	分类规范
2-3-2-1 市场策略	分类规范
2-3-2-2 营销管理	分类规范
2-3-2-3 资费管理	分类规范
2-3-2-4 产品发展策略	分类规范
2-3-3-1 技术管理	分类规范
2-3-3-2 技术研究报告	分类规范
2-3-3-3 专利工作	分类规范
2-3-5-1 财务预算	分类规范
2-3-5-2 业绩披露	分类规范
2-3-5-3 考核相关信息	分类规范
2-3-5-4 生产经营数据	分类规范
2-3-6-1 人力资源	分类规范
2-3-6-2 财务信息	分类规范
2-3-6-3 办公自动化	分类规范
2-3-6-4 采购	分类规范
2-4-1 合作方提供数据	分类规范
2-1-1-1（after） 网络规划类	分类规范
2-1-1-2（after）投资计划类	分类规范
2-1-1-3（after）项目管理类	分类规范
逗号	分隔符
空格	分隔符
制表符	分隔符
分号	分隔符
竖线	分隔符
未覆盖	动态脱敏覆盖业务系统状态
已覆盖	动态脱敏覆盖业务系统状态
医药制造业	医药
http	协议
ftp	协议
smtp	协议
pop3	协议
imap	协议
dns	协议
dhcp	协议
dnp3	协议
snmp	协议
telnet	协议
mysql	协议
oracle	协议
redis	协议
hbase	协议
sqlserver	协议
hive	协议
postgresql	协议
https	协议
x-www-form-urlencoded	参数类型contentType
form-data	参数类型contentType
json	参数类型contentType
text/xml	参数类型contentType
application/xml	参数类型contentType
text/html	参数类型contentType
text/plain	参数类型contentType
其他（不校验）	参数类型contentType
健康	发现任务-健康状态
网路不通	发现任务-健康状态
密码变动	发现任务-健康状态
探针失联	发现任务-健康状态
关联已有数据资产	发现任务关联数据资产类型
关联临时数据资产	发现任务关联数据资产类型
实时	发现任务执行类型
离线	发现任务执行类型
敏感数据发现	发现任务类型
新增	发现状态
修改	发现状态
删除	发现状态
无变化	发现状态
待审批	变更审批状态
已审批	变更审批状态
已驳回	变更审批状态
变更归属	变更类型
变更名称	变更类型
业务系统	变更资产类型（列表）
数据资产	变更资产类型（列表）
对外接口	变更资产类型（列表）
应用情况	变更资产类型（列表）
不涉及	合作方安全
合作方是否签订数据安全协议	合作方安全
合作方人员是否签署数据安全承诺书	合作方安全
是否核实合作方数据安全保护能力	合作方安全
其他	合作方安全
未开始	合规任务执行状态
进行中	合规任务执行状态
暂停中	合规任务执行状态
已停止	合规任务执行状态
已完成	合规任务执行状态
未开始	合规任务状态
进行中	合规任务状态
已完成	合规任务状态
任务失败	合规任务状态
等待中	合规任务状态
未开始	合规任务结果状态
任务失败	合规任务结果状态
任务完成	合规任务结果状态
待派单	合规管理-工单状态
待填报	合规管理-工单状态
待审核	合规管理-工单状态
已审核	合规管理-工单状态
已归档	合规管理-工单状态
待下发	合规评估任务状态
初审中	合规评估任务状态
复审中	合规评估任务状态
初审驳回	合规评估任务状态
复审驳回	合规评估任务状态
待上传	合规评估任务状态
工单完成待提交	合规评估任务状态
报告审批中	合规评估任务状态
归档审批中	合规评估任务状态
报告审批驳回	合规评估任务状态
归档审批驳回	合规评估任务状态
已归档	合规评估任务状态
已过期	合规评估任务状态
待上传	合规评估工单状态
结果待审批	合规评估工单状态
结果审批驳回	合规评估工单状态
待确认	合规评估工单状态
确认待审批	合规评估工单状态
确认审批驳回	合规评估工单状态
已完成	合规评估工单状态
数据资产清单	合规项数据源类型
监测风险预警	合规项数据源类型
4A账号关系	合规项数据源类型
内置	合规项类型
自定义	合规项类型
新增	同步类型
更新	同步类型
删除	同步类型
空	同步类型
未启动	启动状态
已启动	启动状态
响应体	响应信息
响应头	响应信息
在线	在线状态
下线	在线状态
系统	填报内容来源
文件	填报内容来源
历史数据	填报内容来源
保存待提交	填报内容状态
已回退	填报内容状态
已提交	填报内容状态
从系统加载	填报方式
从文件加载	填报方式
从历史数据加载	填报方式
申请加入白名单	处理方式
线下处理	处理方式
其他	处理方式
一键阻断	处理方式
账号封堵	处理方式
bomc封堵	处理方式
防御联动	处理方式
工单下发	处理方式
默认	处理流程
合规上报流程	处理流程
敏感数据上报流程	处理流程
未处置	处理状态
已处置	处理状态
数据访问	处理阶段
数据导出	处理阶段
数据展示	处理阶段
IT运维	处理阶段
开发测试	处理阶段
数据使用安全规范	处理阶段
数据访问控制	处理阶段
数据脱敏处理	处理阶段
数据分析安全	处理阶段
个人信息正当使用	处理阶段
IIMP工单	处置方式
加入白名单	处置方式
忽略	处置方式
线下处理	处置方式
一键阻断	处置方式
账号封堵	处置方式
其他	处置方式
派单处置	处置方式
非本部门数据	处置方式
BOMC工单	处置方式
加入白名单	处置方式
加入金库	处置方式
非超期/超限使用	处置方式定义
已删除	处置方式定义
未派单	处置状态
未处置	处置状态
未审核	处置状态
已审核	处置状态
误报	处置状态
白名单	处置状态
未处置	处置状态
已处置	处置状态
待处置	处置状态
已忽略	处置状态
已处置	处置状态
已处置	处置状态定义
未处置	处置状态定义
aqs_ysq	大数据动态运维租户
jinhui	大数据动态运维租户
EDW_INTF	大数据动态运维租户
hwhive	大数据动态运维租户
wydata	大数据动态运维租户
huawei	大数据动态运维租户
wls	大数据动态运维租户
bonc	大数据动态运维租户
dongruan	大数据动态运维租户
huzc	大数据动态运维租户
wangguan1	大数据动态运维租户
wangguan2	大数据动态运维租户
hnzhizhen	大数据动态运维租户
xintongyuan	大数据动态运维租户
EDW_ADS_TUOMING	大数据动态运维租户
suyan	大数据动态运维租户
OCzhouyi	大数据动态运维租户
OCpengxingsheng	大数据动态运维租户
OCliuxin	大数据动态运维租户
OCheyi	大数据动态运维租户
OCliuchao	大数据动态运维租户
OChuangzhubao	大数据动态运维租户
OCheshitao	大数据动态运维租户
OCxiaoyou	大数据动态运维租户
syhive	大数据动态运维组件
syhbase	大数据动态运维组件
Hive	大数据动态运维组件
Hbase	大数据动态运维组件
HBASE	大数据存储
HIVE	大数据存储
ELASTICSEARCH	大数据存储
FASTDFS	大数据存储
CASICloudDBCP	大数据存储
Impala	大数据存储
Kudu	大数据存储
ARGODB	大数据存储
input-str	字符串
input-str	字符串
NULL	字符串
NULL	字符串
input-str	字符串
input-str	字符串
UTF8	字符集
GBK	字符集
GB2312	字符集
ZHS16GBK	字符集
AL32UTF8	字符集
AMERICAN	字符集
AMERICAZHS16GBK	字符集
数据备份恢复	存储-数据防护能力
数据存储媒介管理	存储-数据防护能力
数据加密存储	存储-数据防护能力
数据隔离	存储-数据防护能力
自行运维管理云平台	存储位置
第三方云平台（中国移动外的云平台）	存储位置
物理机房	存储位置
其他	存储位置
db	存储信息前端显示类型
db	存储信息前端显示类型
db	存储信息前端显示类型
db	存储信息前端显示类型
db	存储信息前端显示类型
db	存储信息前端显示类型
db	存储信息前端显示类型
db	存储信息前端显示类型
db	存储信息前端显示类型
key	存储信息前端显示类型
db	存储信息前端显示类型
db	存储信息前端显示类型
file	存储信息前端显示类型
file	存储信息前端显示类型
file	存储信息前端显示类型
file	存储信息前端显示类型
file	存储信息前端显示类型
db	存储信息前端显示类型
db	存储信息前端显示类型
es	存储信息前端显示类型
file	存储信息前端显示类型
file	存储信息前端显示类型
db	存储信息前端显示类型
db	存储信息前端显示类型
db	存储信息前端显示类型
db	存储信息前端显示类型
db	存储信息前端显示类型
db	存储信息前端显示类型
db	存储信息前端显示类型
db	存储信息前端显示类型
db	存储信息前端显示类型
db	存储信息前端显示类型
db	存储信息前端显示类型
M	存储数数据量单位
G	存储数数据量单位
T	存储数数据量单位
db.DB2	存储类型
db.GBASE	存储类型
db.GREENPLUM	存储类型
db.MYSQL	存储类型
db.ORACLE	存储类型
db.SQLSERVER	存储类型
db.POSTGRESQL	存储类型
db.SYBASE	存储类型
db.MONGODB	存储类型
db.REDIS	存储类型
db.CLICKHOUSE	存储类型
db.TERADATA	存储类型
file.SFTP	存储类型
file.SMB	存储类型
file.CIFS	存储类型
file.FTP	存储类型
file.NFS	存储类型
file.HDFS	存储类型
bigdata.HBASE	存储类型
bigdata.HIVE	存储类型
bigdata.ELASTICSEARCH	存储类型
bigdata.FASTDFS	存储类型
db.GAUSS100	存储类型
db.SPARKSQL	存储类型
bigdata.Impala	存储类型
bigdata.ARGODB	存储类型
db.DM	存储类型
db.Cache	存储类型
db.DRDS(MySQL)	存储类型
db.ShenTong	存储类型
db.GaussDB	存储类型
db.CirroData	存储类型
db.HAWQ	存储类型
db.TIDB	存储类型
db.GoldenDb	存储类型
db.HANA	存储类型
bigdata.Kudu	存储类型
db.Antdb	存储类型
db.Trino	存储类型
db.DORIS	存储类型
db.HOLOGRES	存储类型
数据库存储	存储阶段
大数据平台存储	存储阶段
文件服务存储	存储阶段
数据存储安全管理	存储阶段
数据存储系统安全部署	存储阶段
数据存储系统访问控制	存储阶段
数据存储介质管理	存储阶段
数据备份与恢复	存储阶段
用户个人信息存储	存储阶段
未处置	安全事件-处置状态
处置中	安全事件-处置状态
已处置	安全事件-处置状态
人工	安全任务执行上报-任务执行方式
自动	安全任务执行上报-任务执行方式
一次性任务	安全任务执行上报-是否周期执行
周期性调度任务	安全任务执行上报-是否周期执行
待处置	安全分析预警处置状态
已忽略	安全分析预警处置状态
已处置	安全分析预警处置状态
处置中	安全分析预警处置状态
正常	安全运行状态
异常	安全运行状态
数据识别	安全防护能力覆盖
数据脱敏	安全防护能力覆盖
接口安全管控	安全防护能力覆盖
访问与操作行为安全审计	安全防护能力覆盖
敏感数据流转监测	安全防护能力覆盖
数据安全风险监测	安全防护能力覆盖
防泄漏	安全防护能力覆盖
数据异常行为监测	安全防护能力覆盖
数据加密	安全防护能力覆盖
数据水印	安全防护能力覆盖
数据销毁	安全防护能力覆盖
文档安全	安全防护能力覆盖
访问控制	安全防护能力覆盖
数据库网关	安全防护能力覆盖
隐私计算	安全防护能力覆盖
数据安全管理平台	安全防护能力覆盖
其他	安全防护能力覆盖
进行中	安全风险检查状态
已完成	安全风险检查状态
第1级	定级备案级别
第2级	定级备案级别
第3级	定级备案级别
信任	审计敏感日志风险等级
低	审计敏感日志风险等级
中	审计敏感日志风险等级
高	审计敏感日志风险等级
数据分类分级结果输出服务	对外API管理API类型
业务侧数据内容识别服务	对外API管理API类型
数据脱敏效果验证服务	对外API管理API类型
未报备	对外接口报备状态
已报备	对外接口报备状态
已退回	对外接口报备状态
对外接口高频访问	对外接口检测白名单类型
对外接口敏感数据	对外接口检测白名单类型
对外接口未备案	对外接口检测白名单类型
对外接口传输业务内容合规性	对外接口检测白名单类型
第1级	对应分级name
第2级	对应分级name
第3级	对应分级name
第4级	对应分级name
集团外第三方公司	对端单位类型
省公司	对端单位类型
专业公司	对端单位类型
政府	对端单位类型
事业单位	对端单位类型
企业	对端单位类型
个人	对端单位类型
移动总部	对端单位类型
移动专业公司或其他子公司	对端单位类型
本省公司IT条线	对端单位类型
本省公司网络域内部其他系统	对端单位类型
其他	对端单位类型
文件	对象类型
表	对象类型
视图	对象类型
按列表字段导出	导出字段类型
自定义字段导出	导出字段类型
xlsx	导出文件类型
csv	导出文件类型
已下发	工单状态
处理完成	工单状态
复查通过归档	工单状态
待派单	工单状态
待填报	工单状态
填报中	工单状态
部门待审核	工单状态
平台待审核	工单状态
审核完成	工单状态
已超时	工单状态
敏感数据明文存储或传输	工单类型
未授权调用数据共享接口	工单类型
数据泄露	工单类型
数据完整性非法篡改	工单类型
数据操作行为基线偏离	工单类型
敏感数据未纳入金库管控	工单类型
数据共享接口未经备案	工单类型
数据所在资产脆弱性事件	工单类型
其他	工单类型
一般	工单紧急程度
次要	工单紧急程度
紧急	工单紧急程度
特急	工单紧急程度
已下发	已创建
已完成	已创建
桌面推演	应急演练类型
现网演练	应急演练类型
其他	应急演练类型
HTTP	应用协议
HTTPS	应用协议
Web-API	应用类型
数据API	应用类型
SDK-API	应用类型
第三方API	应用类型
内部API	应用类型
云API	应用类型
IoT-API	应用类型
其他	应用类型
废弃资源综合利用业	废弃资源回收加工
非金屬矿物制品业（除玻璃制品制造、陶瓷制品制造） 	建材
北京	归属4A
广州	归属4A
普通接口	态势上报接口类型
服务接口	态势上报接口类型
人机接口	态势上报接口类型
登录接口	态势上报接口类型
对外接口	态势上报接口类型
跨境接口	态势上报接口类型
文件上传接口	态势上报接口类型
文件下载接口	态势上报接口类型
其它	态势上报接口类型
对称加密	态势上报数据加密情况
非对称加密	态势上报数据加密情况
其他	态势上报数据加密情况
IT网	所属专业
无线	所属专业
接入网	所属专业
核心网	所属专业
WLAN	所属专业
线路	所属专业
动环	所属专业
ICT	所属专业
安全	所属专业
传输	所属专业
数据	所属专业
业务平台	所属专业
其他	所属专业
生产	所属环境
测试	所属环境
网管系统(性能管理系统)	所属系统类型
网管系统(资源管理系统)	所属系统类型
网络客服管理系统	所属系统类型
信令监测系统（VOLTE信令监测系统、5G信令监测系统、7号信令监测系统等）	所属系统类型
上网日志留存系统	所属系统类型
统一DPI系统（2/3/4/5G DPI、互联网DPI、IDC DPI等）	所属系统类型
家客业务支撑系统/家客运维支撑系统/家客业务管理系统/家客综合调度系统等	所属系统类型
集客管理系统/集客运维支撑系统等	所属系统类型
数据共享平台	所属系统类型
端局(MSC)	所属系统类型
HSS/HLR/AUSF/UDM（含携号转网）	所属系统类型
关口局	所属系统类型
AAA	所属系统类型
短信中心	所属系统类型
行业网关	所属系统类型
短信网关	所属系统类型
LBS	所属系统类型
MISC(DSMP)	所属系统类型
其他涉敏系统	所属系统类型
探针扫描	执行方式
手动导入	执行方式
扫描探针	执行能力设备
流转探针	执行能力设备
DLP	执行能力设备
态势平台	执行能力设备
全量	扫描方式
抽样	扫描方式
未扫描	扫描状态
扫描中	扫描状态
已扫描	扫描状态
周报	报告类型
月报	报告类型
日报	报告类型
流转探针	拨测设备类型
扫描探针	拨测设备类型
数据水印	拨测设备类型
数据脱敏	拨测设备类型
数据加密	拨测设备类型
请求类型指标	指标分组
返回类型指标	指标分组
统计类型指标	指标分组
主体类型指标	指标分组
同一接口	指标范围
同一IP	指标范围
同一账号	指标范围
文件	指纹文件类型
图片	指纹文件类型
\r\n(win)	换行符
\n(linux/unix)	换行符
执行中	探针策略下发状态
剔除成功	探针策略下发状态
剔除失败	探针策略下发状态
单IP	探针管理IP策略
多个IP,用逗号分隔	探针管理IP策略
IP区间	探针管理IP策略
IP网段	探针管理IP策略
互联网用户	接口使用方-应用接口备案
电信用户及终端	接口使用方-应用接口备案
合作方	接口使用方-应用接口备案
内部系统	接口使用方-应用接口备案
其他特定群体	接口使用方-应用接口备案
对外接口	接口分类
数据采集接口	接口分类
数据使用接口	接口分类
数据访问接口	接口分类
http	接口协议
https	接口协议
Ftp	接口协议
Sftp	接口协议
其它	接口协议
Http	接口协议-应用接口备案
Https	接口协议-应用接口备案
Ftp	接口协议-应用接口备案
Sftp	接口协议-应用接口备案
其它	接口协议-应用接口备案
流转监测	接口发现来源
接口自学习	接口发现来源
未经审批开通	接口安全属性
暴露面API	接口安全属性
传输个人敏感信息	接口安全属性
传输敏感数据	接口安全属性
未知	接口实现方式
Restful	接口实现方式
GraphQL	接口实现方式
Soap	接口实现方式
Dubbo	接口实现方式
Xml-RPC	接口实现方式
Json-RPC	接口实现方式
gRPC	接口实现方式
WebSocket	接口实现方式
其它	接口实现方式
数据接口	接口属性
页面接口	接口属性
文件接口	接口属性
身份认证	接口已覆盖的安全能力
接口授权	接口已覆盖的安全能力
访问控制	接口已覆盖的安全能力
重要数据识别	接口已覆盖的安全能力
数据脱敏	接口已覆盖的安全能力
日志审计	接口已覆盖的安全能力
数据加密	接口已覆盖的安全能力
传输加密	接口已覆盖的安全能力
攻击防护	接口已覆盖的安全能力
异常行为监测	接口已覆盖的安全能力
数据防泄露	接口已覆盖的安全能力
数据溯源	接口已覆盖的安全能力
流量控制	接口已覆盖的安全能力
API网关	接口已覆盖的安全能力
WAF	接口已覆盖的安全能力
其他	接口已覆盖的安全能力
Restful	接口已覆盖的安全能力
GraphQL	接口已覆盖的安全能力
Soap	接口已覆盖的安全能力
Dubbo	接口已覆盖的安全能力
RPC	接口已覆盖的安全能力
WebSocket	接口已覆盖的安全能力
其它	接口已覆盖的安全能力
网站API	接口应用类型
SDK API	接口应用类型
公众号API	接口应用类型
APP API	接口应用类型
IoT API	接口应用类型
云API	接口应用类型
其他	接口应用类型
主动识别	接口来源
手动添加	接口来源
平台同步	接口来源
生产	接口用途
测试	接口用途
其他	接口用途
生产	接口用途
测试	接口用途
其他	接口用途
FTP	接口类型
API(WebService)	接口类型
API(restful)	接口类型
其他	接口类型
API-KEY签名认证	接口认证方式
Token认证	接口认证方式
数字证书认证	接口认证方式
其他	接口认证方式
无鉴权	接口认证方式
token	接口认证方式
API KEY	接口认证方式-应用接口备案
签名认证	接口认证方式-应用接口备案
Token认证	接口认证方式-应用接口备案
其他	接口认证方式-应用接口备案
无认证方式	接口认证方式-应用接口备案
高活跃	接口调用状态
低活跃	接口调用状态
失活	接口调用状态
复活	接口调用状态
其他	接口调用状态
实时	接口调用频度-应用接口备案
分钟级	接口调用频度-应用接口备案
小时级	接口调用频度-应用接口备案
日级	接口调用频度-应用接口备案
周级	接口调用频度-应用接口备案
月级	接口调用频度-应用接口备案
按需	接口调用频度-应用接口备案
失活	接口调用频度-应用接口备案
其他	接口调用频度-应用接口备案
天	接口调用频度单位
周	接口调用频度单位
月	接口调用频度单位
未鉴权	接口鉴权方式
token	接口鉴权方式
政府	接收方所属单位
事业单位	接收方所属单位
企业	接收方所属单位
个人	接收方所属单位
内部系统	接收方所属单位
其他	接收方所属单位
数据分类分级	控制应用环节
采集	控制应用环节
传输	控制应用环节
存储	控制应用环节
使用	控制应用环节
共享	控制应用环节
销毁	控制应用环节
基础安全	控制应用环节
sftp	操作协议
ssh	操作协议
telnet	操作协议
处理	操作方式
退回	操作方式
误报	操作方式
处理	操作方式
误报	操作方式
新增	操作类型
删除	操作类型
更新	操作类型
查询	操作类型
上传	操作类型
下载	操作类型
导入	操作类型
导出	操作类型
处置	操作类型
标记	操作类型
执行	操作类型
下发	操作类型
停止	操作类型
确认	操作类型
校验	操作类型
登陆	操作类型
登出	操作类型
其他类别	操作类型
复制	操作类型
启用	操作类型
停用	操作类型
密码明文透出	支持AI识别的策略类型
接口COOKIE中包含密码	支持AI识别的策略类型
返回内容包含明文密码	支持AI识别的策略类型
接口单次返回大量个人敏感信息	支持AI识别的策略类型
弱密码成功登录系统	支持AI识别的策略类型
接口请求存在SQL注入获取敏感信息	支持AI识别的策略类型
接口请求存在XSS攻击	支持AI识别的策略类型
接口疑似未鉴权	支持AI识别的策略类型
接口存在数据库操作语句	支持AI识别的策略类型
疑似渗透攻击	支持AI识别的策略类型
接口请求疑似存在SQL注入	支持AI识别的策略类型
数据源鉴别	收集-数据防护能力
数据资产识别	收集-数据防护能力
数据资产标注	收集-数据防护能力
数据分类分级	收集-数据防护能力
数据收集行为监测	收集-数据防护能力
数据资产分布管理	收集-数据防护能力
全部	敏感数据上报工单状态
处理中	敏感数据上报工单状态
退回	敏感数据上报工单状态
已完成	敏感数据上报工单状态
较敏感	敏感数据分类级别
敏感	敏感数据分类级别
极敏感	敏感数据分类级别
第1级	敏感数据分级
第2级	敏感数据分级
第3级	敏感数据分级
第4级	敏感数据分级
视图	敏感数据发现表类型
表	敏感数据发现表类型
待确认	敏感数据接口任务状态
待处理	敏感数据接口任务状态
处理中	敏感数据接口任务状态
已处理	敏感数据接口任务状态
已删除	敏感数据接口任务状态
全部	敏感数据数据审批状态
通过	敏感数据数据审批状态
驳回	敏感数据数据审批状态
全部	敏感数据数据状态
新增	敏感数据数据状态
修改	敏感数据数据状态
删除	敏感数据数据状态
无变化	敏感数据数据状态
已确认	敏感数据确认状态
未确认	敏感数据确认状态
涉敏	敏感状态
未涉敏	敏感状态
待初始化	敏感状态
1级	敏感类型优先级
2级	敏感类型优先级
3级	敏感类型优先级
4级	敏感类型优先级
5级	敏感类型优先级
未分级	敏感级别
1级	敏感级别
2级	敏感级别
3级	敏感级别
4级	敏感级别
数管平台发现	敏感表同步4A历史类型
4A导入	敏感表同步4A历史类型
O域4A	敏感表同步4A域
B域4A	敏感表同步4A域
有效	敏感识别白名单状态
无效	敏感识别白名单状态
作废	敏感识别白名单状态
内部接口	敏感识别白名单类型
外部接口	敏感识别白名单类型
应用接口	敏感识别白名单类型
input-int	数字
input-int	数字
input-int	数字
input-int	数字
input-int	数字
input-int	数字
NULL	数字
NULL	数字
input-str	数字
input-str	数字
正常	数据一致性状态
异常	数据一致性状态
数据分类分级清单	数据上报清单类型
重要核心数据清单	数据上报清单类型
数据安全策略	数据上报清单类型
数据安全事件	数据上报清单类型
数据识别特征	数据上报清单类型
数据共享接口	数据上报清单类型
数据安全任务执行情况	数据上报清单类型
数据安全问题处置与跟踪情况	数据上报清单类型
数据安全防护能力建设情况	数据上报清单类型
网络数据安全责任矩阵	数据上报清单类型
涉敏系统清单	数据上报清单类型
涉敏人员清单	数据上报清单类型
数据权限清单	数据上报清单类型
数据库原始日志文件	数据上报清单类型
未上报	数据上报状态
上报中	数据上报状态
上报成功	数据上报状态
上报失败	数据上报状态
待确认	数据上报状态
资产实时流量统计	数据上报类型
数据接口服务	数据上报类型
流量监测接口	数据上报类型
敏感数据发现	数据上报类型
数据库审计	数据上报类型
跨境	数据传输场景
跨外部主体	数据传输场景
跨电信内部单位	数据传输场景
跨本单位系统	数据传输场景
系统内部间	数据传输场景
其他	数据传输场景
跨境	数据传输场景
跨外部主体	数据传输场景
跨电信内部单位	数据传输场景
跨本单位系统	数据传输场景
系统内部间	数据传输场景
其它	数据传输场景
FTP	数据共享接口上报-接口类型
API(WebService)	数据共享接口上报-接口类型
API(restful)	数据共享接口上报-接口类型
SFTP	数据共享接口上报-接口类型
旁路镜像及重定向	数据共享接口上报-接口类型
其他	数据共享接口上报-接口类型
政府	数据共享接口上报-接收方所属单位
事业单位	数据共享接口上报-接收方所属单位
企业	数据共享接口上报-接收方所属单位
个人	数据共享接口上报-接收方所属单位
移动总部	数据共享接口上报-接收方所属单位
移动专业公司或其他子公司	数据共享接口上报-接收方所属单位
本省公司IT条线	数据共享接口上报-接收方所属单位
本省公司网络域内部其他系统	数据共享接口上报-接收方所属单位
其他	数据共享接口上报-接收方所属单位
互联网点对点	数据出境方式
专线传输	数据出境方式
VPN传输	数据出境方式
接口调用传输	数据出境方式
离线传输（包括但不限于：硬盘、U盘、光盘、纸质文件）	数据出境方式
其他	数据出境方式
低敏感级	数据分类对应数据分级等级
较敏感级	数据分类对应数据分级等级
敏感级	数据分类对应数据分级等级
极敏感级	数据分类对应数据分级等级
对称加密	数据加密情况
非对称加密	数据加密情况
杂凑加密	数据加密情况
明文传输	数据加密情况
正常	数据发现探针-健康状态
异常	数据发现探针-健康状态
启用	数据发现探针-启用状态
停用	数据发现探针-启用状态
执行中	数据发现探针-运行状态
空闲	数据发现探针-运行状态
收集	数据处理使用方式
存储	数据处理使用方式
使用	数据处理使用方式
加工	数据处理使用方式
传输	数据处理使用方式
提供	数据处理使用方式
公开	数据处理使用方式
企业经营	数据处理目的
运行维护	数据处理目的
科学研究	数据处理目的
监管支撑	数据处理目的
其他	数据处理目的
国有企业	数据处理者性质
民营企业	数据处理者性质
外资企业	数据处理者性质
合资企业	数据处理者性质
事业单位	数据处理者性质
科研机构	数据处理者性质
其他	数据处理者性质
低	数据安全事件-风险事件级别
中	数据安全事件-风险事件级别
高	数据安全事件-风险事件级别
敏感数据明文存储或传输	数据安全事件上报-事件类型
未授权调用数据共享接口	数据安全事件上报-事件类型
数据泄露	数据安全事件上报-事件类型
数据完整性非法篡改	数据安全事件上报-事件类型
数据操作行为基线偏离	数据安全事件上报-事件类型
敏感数据未纳入金库管控	数据安全事件上报-事件类型
数据共享接口未经备案	数据安全事件上报-事件类型
数据所在资产脆弱性事件	数据安全事件上报-事件类型
重要数据安全风险事件	数据安全事件上报-事件类型
数据批量导出风险事件	数据安全事件上报-事件类型
数据高频访问风险事件	数据安全事件上报-事件类型
个人信息未去标识化风险事件	数据安全事件上报-事件类型
文件外发风险事件	数据安全事件上报-事件类型
其他	数据安全事件上报-事件类型
敏感数据识别与发现任务	数据安全任务执行情况上报-数据安全任务类型
数据脱敏任务	数据安全任务执行情况上报-数据安全任务类型
数据核查任务	数据安全任务执行情况上报-数据安全任务类型
重要数据识别与发现任务	数据安全任务执行情况上报-数据安全任务类型
重要数据风险监测任务	数据安全任务执行情况上报-数据安全任务类型
其他	数据安全任务执行情况上报-数据安全任务类型
敏感数据识别与发现任务	数据安全任务类型
数据脱敏任务	数据安全任务类型
数据核查任务	数据安全任务类型
其他	数据安全任务类型
综调	数据安全分析预警-ueba预警类型
业管	数据安全分析预警-ueba预警类型
已生成	数据安全分析预警-ueba风险工单状态
已派单	数据安全分析预警-ueba风险工单状态
已接单	数据安全分析预警-ueba风险工单状态
处理中	数据安全分析预警-ueba风险工单状态
申请挂起	数据安全分析预警-ueba风险工单状态
已挂起	数据安全分析预警-ueba风险工单状态
转单	数据安全分析预警-ueba风险工单状态
再次派单	数据安全分析预警-ueba风险工单状态
申请归档	数据安全分析预警-ueba风险工单状态
已结束	数据安全分析预警-ueba风险工单状态
平台内派单	数据安全分析预警派单处理方式
忽略	数据安全分析预警派单处理方式
第三方派发工单	数据安全分析预警派单处理方式
上海电信第三方派单	数据安全分析预警派单处理方式
未处置	数据安全处置状态
处置中	数据安全处置状态
已处置	数据安全处置状态
法律法规	数据安全标准类型
国家标准	数据安全标准类型
规章制度	数据安全标准类型
行业要求	数据安全标准类型
公司制度	数据安全标准类型
脱敏策略	数据安全策略上报-策略类型
加密策略	数据安全策略上报-策略类型
访问控制策略	数据安全策略上报-策略类型
数据防泄漏策略	数据安全策略上报-策略类型
数据库审计策略	数据安全策略上报-策略类型
数据共享接口分析策略	数据安全策略上报-策略类型
数据异常访问行为分析策略	数据安全策略上报-策略类型
用户操作审计策略	数据安全策略上报-策略类型
其他	数据安全策略上报-策略类型
已下发	数据安全问题处置与跟踪情况上报-工单状态
处理完成	数据安全问题处置与跟踪情况上报-工单状态
复查通过归档	数据安全问题处置与跟踪情况上报-工单状态
数据脱敏类	数据安全防护能力建设情况上报-防护能力类型
数据防泄漏类	数据安全防护能力建设情况上报-防护能力类型
数据加密类	数据安全防护能力建设情况上报-防护能力类型
数据水印类	数据安全防护能力建设情况上报-防护能力类型
数据库审计类	数据安全防护能力建设情况上报-防护能力类型
数据安全网关类	数据安全防护能力建设情况上报-防护能力类型
溯源分析类	数据安全防护能力建设情况上报-防护能力类型
终端行为管控类	数据安全防护能力建设情况上报-防护能力类型
其他类	数据安全防护能力建设情况上报-防护能力类型
待下发	数据安全风险工单状态
待处理	数据安全风险工单状态
待提交	数据安全风险工单状态
待审批	数据安全风险工单状态
审批中	数据安全风险工单状态
审批驳回	数据安全风险工单状态
待复审	数据安全风险工单状态
待归档	数据安全风险工单状态
已归档	数据安全风险工单状态
复审驳回	数据安全风险工单状态
归档驳回	数据安全风险工单状态
运维风险工单	数据安全风险工单类型
合规风险工单	数据安全风险工单类型
数据安全风险检查	数据安全风险检查任务类别定义
敏感数据识别合规评估	数据安全风险检查任务类别定义
数据资产备案合规评估	数据安全风险检查任务类别定义
脱敏验证合规评估	数据安全风险检查任务类别定义
数据防泄漏合规评估	数据安全风险检查任务类别定义
数据对外开放共享风险评级	数据安全风险检查任务类别定义
接口访问可遍历风险	数据安全风险类型
接口敏感数据风险	数据安全风险类型
WEB敏感数据风险	数据安全风险类型
敏感文件传输风险	数据安全风险类型
明文传输风险	数据安全风险类型
重要数据明文传输	数据安全风险类型
个人信息去标识化不规范	数据安全风险类型
接口可执行SQL	数据安全风险类型
数据库删除操作异常风险	数据安全风险类型
数据库查询操作异常风险	数据安全风险类型
数据库新增操作异常风险	数据安全风险类型
数据库修改操作异常风险	数据安全风险类型
接口高频访问	数据安全风险类型
敏感数据访问频次异常	数据安全风险类型
批量操作异常风险	数据安全风险类型
重要业务访问频次异常	数据安全风险类型
暴力破解风险	数据安全风险类型
批量爬取接口数据	数据安全风险类型
接口批量下载数据	数据安全风险类型
接口高频登录尝试	数据安全风险类型
频繁登录	数据安全风险类型
非常用时间访问	数据安全风险类型
非常用目的端口访问	数据安全风险类型
非常用源端口使用	数据安全风险类型
非常用目的ip	数据安全风险类型
敏感数据批量访问	数据安全风险类型
接口未备案风险	数据安全风险类型
未备案资源被访问风险	数据安全风险类型
接口访问未鉴权风险	数据安全风险类型
端口探测风险	数据安全风险类型
僵尸账号	数据安全风险类型
尝试登录次数过多	数据安全风险类型
异常网页访问	数据安全风险类型
敏感数据越权访问	数据安全风险类型
接口失活风险	数据安全风险类型
流量异常风险	数据安全风险类型
数据流转范围异常	数据安全风险类型
数据流转时间异常	数据安全风险类型
数据流转路径异常	数据安全风险类型
访问关系异常风险	数据安全风险类型
其他风险	数据安全风险类型
共享转让	数据对外提供情况
公开披露	数据对外提供情况
数据出境	数据对外提供情况
其他情况	数据对外提供情况
不涉及对外提供	数据对外提供情况
TELEPG	数据库
TELEDB	数据库
OCEANBASE	数据库
RDS(MYSQL)	数据库
SYBASEIQ	数据库
DM	数据库
Cache	数据库
DRDS(MySQL)	数据库
ShenTong	数据库
GaussDB	数据库
CirroData	数据库
HAWQ	数据库
TIDB	数据库
GoldenDb	数据库
HANA	数据库
Antdb	数据库
Trino	数据库
DORIS	数据库
HOLOGRES	数据库
AIDB	数据库
DB2	数据库
GBASE	数据库
GREENPLUM	数据库
MYSQL	数据库
ORACLE	数据库
SQLSERVER	数据库
POSTGRESQL	数据库
SYBASE	数据库
MONGODB	数据库
REDIS	数据库
CLICKHOUSE	数据库
TERADATA	数据库
LDAP	数据库
MariaDB	数据库
Vertica	数据库
COONTEXTPOOL	数据库
KINGBASE	数据库
POLARDB	数据库
GAUSS100	数据库
SPARKSQL	数据库
数据库原始日志	数据库原始日志-文件类型
全量数据库表结构文件	数据库原始日志-文件类型
查询	数据库审计操作类型
修改	数据库审计操作类型
删除	数据库审计操作类型
添加	数据库审计操作类型
原始数据	数据提供形式
验真数据	数据提供形式
统计级数据	数据提供形式
标签数据	数据提供形式
其他	数据提供形式
接口（包括FTP、SFTP、API、旁路镜像及重定向等方式）	数据提供方式
线下	数据提供方式
邮件	数据提供方式
其他	数据提供方式
设备采集	数据来源
设备产生	数据来源
人工填报	数据来源
交易购买	数据来源
共享交互	数据来源
其他	数据来源
用户提供	数据来源
外部获取（合作共享、购买等）	数据来源
互联网爬虫	数据来源
生产运营中产生	数据来源
统计分析结果	数据来源
其他	数据来源
业务网	数据流转监控位置
承载网	数据流转监控位置
外网	数据流转监控位置
HTTP	数据流转监控协议类型
HTTPS	数据流转监控协议类型
SSH	数据流转监控协议类型
FTP	数据流转监控协议类型
MYSQL	数据流转监控协议类型
ORACLE	数据流转监控协议类型
HIVE	数据流转监控协议类型
HBASE	数据流转监控协议类型
REDIS	数据流转监控协议类型
SQLSERVER	数据流转监控协议类型
POSTGRESQL	数据流转监控协议类型
SYSBASE	数据流转监控协议类型
DM	数据流转监控协议类型
OSCAR	数据流转监控协议类型
MONGODB	数据流转监控协议类型
CLICKHOUSE	数据流转监控协议类型
GBASE	数据流转监控协议类型
TERADATA	数据流转监控协议类型
FASTDFS	数据流转监控协议类型
HDFS	数据流转监控协议类型
ELASTICSEARCH	数据流转监控协议类型
ZABBIXAGENT	数据流转监控协议类型
ZABBIXSERVER	数据流转监控协议类型
OTHER	数据流转监控协议类型
00:00~01:00	数据流转监控时间范围
01:00~02:00	数据流转监控时间范围
02:00~03:00	数据流转监控时间范围
03:00~04:00	数据流转监控时间范围
04:00~05:00	数据流转监控时间范围
05:00~06:00	数据流转监控时间范围
06:00~07:00	数据流转监控时间范围
07:00~08:00	数据流转监控时间范围
08:00~09:00	数据流转监控时间范围
09:00~10:00	数据流转监控时间范围
10:00~11:00	数据流转监控时间范围
11:00~12:00	数据流转监控时间范围
12:00~13:00	数据流转监控时间范围
13:00~14:00	数据流转监控时间范围
14:00~15:00	数据流转监控时间范围
15:00~16:00	数据流转监控时间范围
16:00~17:00	数据流转监控时间范围
17:00~18:00	数据流转监控时间范围
18:00~19:00	数据流转监控时间范围
19:00~20:00	数据流转监控时间范围
20:00~21:00	数据流转监控时间范围
21:00~22:00	数据流转监控时间范围
22:00~23:00	数据流转监控时间范围
23:00~00:00	数据流转监控时间范围
应用服务	数据流转监控服务类型
接口服务	数据流转监控服务类型
南向	数据流转监控流向
北向	数据流转监控流向
生产运维区	数据流量监控-部署位置
生产运营区	数据流量监控-部署位置
姓名（人名）	数据特征
地址（地名）	数据特征
手机号码	数据特征
IMEI	数据特征
IMSI	数据特征
身份证号码	数据特征
IP	数据特征
邮箱	数据特征
银行卡号码	数据特征
驾照号码	数据特征
其他	数据特征
姓名（人名）	数据特征
地址（地名）	数据特征
手机号码	数据特征
IMEI	数据特征
IMSI	数据特征
身份证号码	数据特征
IP	数据特征
邮箱	数据特征
银行卡号码	数据特征
驾照号码	数据特征
其他	数据特征
第一级	数据特征优先级
第二级	数据特征优先级
第三级	数据特征优先级
第四级	数据特征优先级
第五级	数据特征优先级
数据收集	数据生命周期环节
数据传输	数据生命周期环节
数据存储	数据生命周期环节
数据使用加工	数据生命周期环节
数据提供（共享）	数据生命周期环节
数据公开	数据生命周期环节
数据销毁	数据生命周期环节
文件类非结构化数据	数据类型
数据库类结构化数据	数据类型
手工添加	数据类型
手工导入	数据类型
系统同步	数据类型
条	数据精度
个	数据精度
份	数据精度
BYTE	数据精度
重要数据	数据级别
核心数据	数据级别
未识别	数据级别
一般数据	数据级别
重要数据	数据级别
核心数据	数据级别
一般数据	数据级别-应用接口备案
重要数据	数据级别-应用接口备案
核心数据	数据级别-应用接口备案
未识别	数据级别-应用接口备案
正则表达式	数据识别规则上报-识别规则类型
自然语言处理（NLP）	数据识别规则上报-识别规则类型
AI	数据识别规则上报-识别规则类型
列名	数据识别规则上报-识别规则类型
文档指纹	数据识别规则上报-识别规则类型
文件属性	数据识别规则上报-识别规则类型
关键字	数据识别规则上报-识别规则类型
知识库	数据识别规则上报-识别规则类型
其他	数据识别规则上报-识别规则类型
待初始化	数据资产核查标识
待核查	数据资产核查标识
已核查	数据资产核查标识
脱敏	数据资产防护能力
防泄漏	数据资产防护能力
加密	数据资产防护能力
水印	数据资产防护能力
审计	数据资产防护能力
安全网关	数据资产防护能力
溯源分析	数据资产防护能力
终端行为管控	数据资产防护能力
检测预警	数据资产防护能力
其他	数据资产防护能力
与互联网相连的信息系统	数据载体
不与互联网相连的信息系统	数据载体
其他电子化数据	数据载体
非电子化数据	数据载体
非本部门数据	数据防护异常4a审计预警处置方式
加入白名单	数据防护异常4a审计预警处置方式
纳入4A管控	数据防护异常4a审计预警处置方式
非本部门数据	数据防护异常日志涉敏审计预警处置方式
加入白名单	数据防护异常日志涉敏审计预警处置方式
加入金库	数据防护异常日志涉敏审计预警处置方式
IIMP工单	数据防护异常日志涉敏审计预警处置方式
系统接入4A审计预警	数据防护异常预警类型
日志涉敏审计预警	数据防护异常预警类型
加密	数据防护方式
脱敏	数据防护方式
普通	数据防护方式
加密文件	文件内容类型
代码文件	文件内容类型
FTP	文件存储
NFS	文件存储
SFTP	文件存储
SMB	文件存储
HDFS	文件存储
CIFS	文件存储
DOC	文件格式类型
XLS	文件格式类型
PPT	文件格式类型
DOCX	文件格式类型
XLSX	文件格式类型
PPTX	文件格式类型
TXT	文件格式类型
XML	文件格式类型
LOG	文件格式类型
PDF	文件格式类型
JSON	文件格式类型
HTML	文件格式类型
AVI	文件格式类型
FLV	文件格式类型
RMVB	文件格式类型
MP4	文件格式类型
MVB	文件格式类型
WMA	文件格式类型
MP3	文件格式类型
MPG	文件格式类型
3GP	文件格式类型
OBJ	文件格式类型
O	文件格式类型
JAVA	文件格式类型
C	文件格式类型
CPP	文件格式类型
PY	文件格式类型
JS	文件格式类型
CSS	文件格式类型
PHP	文件格式类型
GO	文件格式类型
SH	文件格式类型
CS	文件格式类型
PSD	文件格式类型
GIF	文件格式类型
JAR	文件格式类型
MOV	文件格式类型
MPEG	文件格式类型
EXE	文件格式类型
RAR	文件格式类型
7Z	文件格式类型
ZIP	文件格式类型
JPG	文件格式类型
PNG	文件格式类型
CSV	文件格式类型
CSV	文件格式类型
Ftp	文件资产类型
Sftp	文件资产类型
Smb	文件资产类型
Hdfs	文件资产类型
其他文件资产	文件资产类型
启用	日志配置是否启用
停用	日志配置是否启用
食品	日用杂品制造
农副食品加工	日用杂品制造
食品制造业	日用杂品制造
酒、饮料和精制茶制造业	日用杂品制造
非本部门数据	明文传输预警处置方式
加入白名单	明文传输预警处置方式
加密传输	明文传输预警处置方式
是	是否
否	是否
否	是否业务网访问
是	是否业务网访问
否	是否外网访问
是	是否外网访问
否	是否承载网访问
是	是否承载网访问
未涉及	是否涉及
涉及	是否涉及
是	是或者否
否	是或者否
无	有或者无
有	有或者无
有色金屬治炼和压延加工业	有色
流量发现	未知资产来源
手动添加	未知资产来源
端口扫描	未知资产来源
观镜发现	未知资产来源
众包平台	未覆盖系统
金属制品业（除金属制日用品制造）	机械
通用设备制造业	机械
专用设备制造业	机械
电气机械和器材制造业（除电池制造、家用电力器具制造、非电力家用器具制造、照明照具制造）	机械
仪器仪表制造业	机械
金属制品、机械和设备修理业	机械
技术类	标准安全库解读
管理类	标准安全库解读
使用场景	标签使用分类
活跃指数	标签使用分类
生命周期	标签使用分类
业务用途	标签使用分类
敏感情况	标签使用分类
接口	标签应用范围
IP	标签应用范围
账号	标签应用范围
数据库	标签应用范围
数据表	标签应用范围
生产系统	核心数据清单-信息系统类型
运维系统	核心数据清单-信息系统类型
管理系统	核心数据清单-信息系统类型
业务支撑系统	核心数据清单-信息系统类型
安全保障系统	核心数据清单-信息系统类型
其他	核心数据清单-信息系统类型
互联网点对点	核心数据清单-数据对外共享方式
专线传输	核心数据清单-数据对外共享方式
VPN传输	核心数据清单-数据对外共享方式
接口调用传输	核心数据清单-数据对外共享方式
离线传输（包括但不限于：硬盘、U盘、光盘、纸质文件）	核心数据清单-数据对外共享方式
其他	核心数据清单-数据对外共享方式
未开展网络安全等级保护认定	核心数据清单-系统网络安全定级认定情况
1级	核心数据清单-系统网络安全定级认定情况
2级	核心数据清单-系统网络安全定级认定情况
3级	核心数据清单-系统网络安全定级认定情况
4级	核心数据清单-系统网络安全定级认定情况
未开展通信网络安全防护定级备案	核心数据清单-通信网络安全防护备案
一级	核心数据清单-通信网络安全防护备案
二级	核心数据清单-通信网络安全防护备案
三级	核心数据清单-通信网络安全防护备案
四级	核心数据清单-通信网络安全防护备案
五级	核心数据清单-通信网络安全防护备案
未核查	核查任务核查状态
已保存	核查任务核查状态
已完成	核查任务核查状态
查看	核查日志操作类型
导入	核查日志操作类型
导出	核查日志操作类型
引擎检测	检测方法
业务检测	检测方法
手动打标	检测方法
内置-清单	模版类型
内置-文件	模版类型
自定义-清单	模版类型
自定义-文件	模版类型
未模糊化	模糊化状态
已模糊化	模糊化状态
汽车制造业	汽车
实时流量统计日志	流转上报日志
预警信息上报日志	流转上报日志
数据库审计日志	流转上报日志
小时	流转合并周期单位
天	流转合并周期单位
周	流转合并周期单位
月	流转合并周期单位
电话号码	流转探针策略
身份证号	流转探针策略
SM卡号	流转探针策略
IMSI号	流转探针策略
地址	流转探针策略
运维	流转探针类型
运行	流转探针类型
输入	流转标签
输出	流转标签
数据库	流转标签
文件服务	流转标签
主机	涉敏人员从账号类型
数据库	涉敏人员从账号类型
前台应用	涉敏人员从账号类型
新增	涉敏人员状态
删除	涉敏人员状态
修改	涉敏人员状态
手工创建	涉敏场景来源
批量上报	涉敏场景来源
姓名	涉敏数据未加密
地址	涉敏数据未加密
身份证	涉敏数据未加密
邮箱	涉敏数据未加密
手机号	涉敏数据未加密
姓名	涉敏数据未加金库
地址	涉敏数据未加金库
身份证	涉敏数据未加金库
邮箱	涉敏数据未加金库
手机号	涉敏数据未加金库
姓名	涉敏数据未脱敏
地址	涉敏数据未脱敏
身份证	涉敏数据未脱敏
邮箱	涉敏数据未脱敏
admin	特权用户名单
root	特权用户名单
运维	生产访问白名单区域
运行	生产访问白名单区域
越权访问	生产访问白名单类型
绕行访问	生产访问白名单类型
非工作段访问	生产访问白名单类型
已标识	生命周期任务状态
部分标识	生命周期任务状态
未标识	生命周期任务状态
数据采集	生命周期阶段
数据传输	生命周期阶段
数据存储	生命周期阶段
数据共享	生命周期阶段
数据使用	生命周期阶段
数据销毁	生命周期阶段
Mysql	电信上报数据资产类型
Oracle	电信上报数据资产类型
Postgresql	电信上报数据资产类型
Sqlserver	电信上报数据资产类型
Sybase	电信上报数据资产类型
Informix	电信上报数据资产类型
DB2	电信上报数据资产类型
Hive	电信上报数据资产类型
Hbase	电信上报数据资产类型
TeleDB	电信上报数据资产类型
TelePG	电信上报数据资产类型
ClickHouse	电信上报数据资产类型
Mariadb	电信上报数据资产类型
UDAL	电信上报数据资产类型
OrientDB	电信上报数据资产类型
NuoDB	电信上报数据资产类型
Vertica	电信上报数据资产类型
Cratedb	电信上报数据资产类型
Monetdb	电信上报数据资产类型
Yugabytedb	电信上报数据资产类型
Greenplum	电信上报数据资产类型
Exasol	电信上报数据资产类型
PrestoDB	电信上报数据资产类型
CockroachDB	电信上报数据资产类型
TimescaleDB	电信上报数据资产类型
Trino	电信上报数据资产类型
Machbase	电信上报数据资产类型
人大金仓	电信上报数据资产类型
达梦	电信上报数据资产类型
Tidb	电信上报数据资产类型
神通	电信上报数据资产类型
巨杉	电信上报数据资产类型
涛思	电信上报数据资产类型
Oceanbase	电信上报数据资产类型
高斯	电信上报数据资产类型
南通	电信上报数据资产类型
镜舟	电信上报数据资产类型
亚信	电信上报数据资产类型
云和恩墨	电信上报数据资产类型
翰高	电信上报数据资产类型
万里	电信上报数据资产类型
MongoDb	电信上报数据资产类型
Redis	电信上报数据资产类型
Elasticsearch	电信上报数据资产类型
Kafka	电信上报数据资产类型
RocketMQ	电信上报数据资产类型
Memcached	电信上报数据资产类型
其他数据资产	电信上报数据资产类型
Ftp	电信上报文件资产类型
Sftp	电信上报文件资产类型
Smb	电信上报文件资产类型
Hdfs	电信上报文件资产类型
其他数据资产	电信上报文件资产类型
新增或更新	电信数据上报-工单业务系统清单
删除	电信数据上报-工单业务系统清单
业务系统信息模板	电信数据上报-工单模板
数据资产信息模板	电信数据上报-工单模板
传输	电信数据上报-所属专业
数据	电信数据上报-所属专业
业务平台	电信数据上报-所属专业
IT网	电信数据上报-所属专业
无线	电信数据上报-所属专业
接入网	电信数据上报-所属专业
核心网	电信数据上报-所属专业
动环	电信数据上报-所属专业
安全	电信数据上报-所属专业
未分配	电信数据上报-所属专业
一级	电信数据上报-数据分级
二级	电信数据上报-数据分级
三级	电信数据上报-数据分级
四级	电信数据上报-数据分级
北京市	电信数据上报-系统地域
天津市	电信数据上报-系统地域
河北省	电信数据上报-系统地域
山西省	电信数据上报-系统地域
内蒙古自治区	电信数据上报-系统地域
辽宁省	电信数据上报-系统地域
吉林省	电信数据上报-系统地域
黑龙江省	电信数据上报-系统地域
上海市	电信数据上报-系统地域
江苏省	电信数据上报-系统地域
浙江省	电信数据上报-系统地域
安徽省	电信数据上报-系统地域
福建省	电信数据上报-系统地域
江西省	电信数据上报-系统地域
山东省	电信数据上报-系统地域
河南省	电信数据上报-系统地域
湖北省	电信数据上报-系统地域
湖南省	电信数据上报-系统地域
广东省	电信数据上报-系统地域
广西壮族自治区	电信数据上报-系统地域
海南省	电信数据上报-系统地域
重庆市	电信数据上报-系统地域
四川省	电信数据上报-系统地域
贵州省	电信数据上报-系统地域
云南省	电信数据上报-系统地域
西藏自治区	电信数据上报-系统地域
陕西省	电信数据上报-系统地域
甘肃省	电信数据上报-系统地域
青海省	电信数据上报-系统地域
宁夏回族自治区	电信数据上报-系统地域
新疆维吾尔自治区	电信数据上报-系统地域
北京市	电信数据上报-资产地域
天津市	电信数据上报-资产地域
河北省	电信数据上报-资产地域
山西省	电信数据上报-资产地域
内蒙古自治区	电信数据上报-资产地域
辽宁省	电信数据上报-资产地域
吉林省	电信数据上报-资产地域
黑龙江省	电信数据上报-资产地域
上海市	电信数据上报-资产地域
江苏省	电信数据上报-资产地域
浙江省	电信数据上报-资产地域
安徽省	电信数据上报-资产地域
福建省	电信数据上报-资产地域
江西省	电信数据上报-资产地域
山东省	电信数据上报-资产地域
河南省	电信数据上报-资产地域
湖北省	电信数据上报-资产地域
湖南省	电信数据上报-资产地域
广东省	电信数据上报-资产地域
广西壮族自治区	电信数据上报-资产地域
海南省	电信数据上报-资产地域
重庆市	电信数据上报-资产地域
四川省	电信数据上报-资产地域
贵州省	电信数据上报-资产地域
云南省	电信数据上报-资产地域
西藏自治区	电信数据上报-资产地域
陕西省	电信数据上报-资产地域
甘肃省	电信数据上报-资产地域
青海省	电信数据上报-资产地域
宁夏回族自治区	电信数据上报-资产地域
新疆维吾尔自治区	电信数据上报-资产地域
新增或更新	电信数据上报-资产状态
删除	电信数据上报-资产状态
数据表单	电信数据上报-载体类型
电子文档	电信数据上报-载体类型
纸质文件	电信数据上报-载体类型
图片	电信数据上报-载体类型
音视频	电信数据上报-载体类型
其他	电信数据上报-载体类型
时增量	电信数据上报模式
日增量	电信数据上报模式
服务健康信息	电信数据上报类型
信息系统信息	电信数据上报类型
信息系统数据安全台账	电信数据上报类型
数据库资产信息	电信数据上报类型
文件系统资产信息	电信数据上报类型
API资产台账	电信数据上报类型
API安全风险排查及整改信息	电信数据上报类型
API资产访问情况	电信数据上报类型
敏感数据表信息	电信数据上报类型
敏感数据字段信息	电信数据上报类型
敏感文件信息	电信数据上报类型
风险事件信息	电信数据上报类型
计算机、通信及其他电子设备制造业	电子设备制造
有效	白名单状态
无效	白名单状态
作废	白名单状态
源IP	监测范围
接口	监测范围
应用	监测范围
数据库表	监测范围
off	监测范围下发开关
进行中	离线任务状态
任务完成	离线任务状态
任务失败	离线任务状态
待申请	离线审批状态
待审批	离线审批状态
已审批	离线审批状态
已驳回	离线审批状态
数据资产	离线资产类型
数据资产（离线）	离线资产类型
业务系统	离线资产类型（列表）
数据资产	离线资产类型（列表）
数据资产（离线）	离线资产类型（列表）
通过	离线验证结果
不通过	离线验证结果
用户数限制	租户业务容量
程序帐号	程序帐号类型
非程序帐号	程序帐号类型
非本部门数据	稽核问题处置类型
加入白名单	稽核问题处置类型
转派本部门其他人员	稽核问题处置类型
直接处置	稽核问题处置类型
定级备案信息校验	稽核问题类型
涉敏信息不准确校验_客户信息涉敏	稽核问题类型
涉敏信息不准确校验_是否涉敏（A-H）	稽核问题类型
4A纳入情况校验	稽核问题类型
涉敏应用系统遗漏校验	稽核问题类型
后台涉敏场景遗漏校验	稽核问题类型
涉敏等级校验	稽核问题类型
前台涉敏场景遗漏校验	稽核问题类型
敏感数据发现任务	站内信发送源
敏感数据发现结果核查	站内信发送源
资产导入	站内信发送源
对外接口	站内信发送源
涉敏场景导入	站内信发送源
涉敏人员导入	站内信发送源
能力策略导入	站内信发送源
应用情况导入	站内信发送源
核查管理导出	站内信发送源
数据资产导出	站内信发送源
对外服务列表导入	站内信发送源
对外服务列表详情导入	站内信发送源
对外应用访问导入	站内信发送源
对外应用访问详情导入	站内信发送源
后端数据访问导入	站内信发送源
后端数据访问详情导入	站内信发送源
核查管理导入	站内信发送源
数据生命周期导入	站内信发送源
4A绕行白名单导入	站内信发送源
离线任务结果导入	站内信发送源
一键核查	站内信发送源
事件视图导出	站内信发送源
脱敏策略导入	站内信发送源
脱敏验证任务	站内信发送源
资产清单导入	站内信发送源
资产清单导出	站内信发送源
资产清单无归属资产导出	站内信发送源
系统资源监控	站内信发送源
数据一致性校验	站内信发送源
核查统计导出	站内信发送源
数据资产分类分级清单	站内信发送源
数据资产重要数据清单导出	站内信发送源
数据资产表清单导出	站内信发送源
数据上报	站内信发送源
平台堡垒机管理导入	站内信发送源
管理策略导出	站内信发送源
对外接口导出	站内信发送源
数据安全态势导入	站内信发送源
4A绕行管理	站内信发送源
资产变更管控	站内信发送源
资产下线管控	站内信发送源
对外接口报备	站内信发送源
涉敏信息	站内信发送源
数据资产上报	站内信发送源
敏感数据识别上报	站内信发送源
数据事件上报	站内信发送源
拨测上报	站内信发送源
数据策略上报	站内信发送源
分类分级清单上报	站内信发送源
重要数据清单上报	站内信发送源
策略上报	站内信发送源
安全事件上报	站内信发送源
数据识别规则上报	站内信发送源
接口资产上报	站内信发送源
数据安全任务上报	站内信发送源
问题处理和跟踪上报	站内信发送源
能力上报	站内信发送源
合规作业下发	站内信发送源
合规性管理	站内信发送源
文件下载	站内信发送源
导出失败	站内信发送源
导出成功	站内信发送源
导入失败	站内信发送源
导入成功	站内信发送源
探针告警	站内信发送源
风险事件	站内信发送源
业务系统信息	站内信发送源
数据资产信息	站内信发送源
未知资产	站内信发送源
4A资源组同步提示	站内信发送源
4A资源同步提示	站内信发送源
已读	站内信消息状态
未读	站内信消息状态
一级	等保等级
二级	等保等级
三级	等保等级
四级	等保等级
五级	等保等级
一级	等保级别
二级	等保级别
三级	等保级别
四级	等保级别
五级	等保级别
业务策略补执行	策略事件
防护能力策略审批	策略事件
分类分级能力策略审批	策略事件
管理策略审批	策略事件
能力策略执行	策略事件
未完成	策略完成状态
已完成	策略完成状态
123	策略完成状态
未通过	策略审批结果
已通过	策略审批结果
未审批	策略审批结果
敏感数据分类分级策略	策略类型
数据脱敏策略	策略类型
分类分级策略	策略类型
数据流转监控策略	策略类型
数据脱敏策略	策略类型
数据加密策略	策略类型
数据水印策略	策略类型
金库策略	策略类型
数据加密策略	策略类型
数据水印策略	策略类型
数据模糊化策略	策略类型
脱敏策略	策略类型
加密策略	策略类型
访问控制策略	策略类型
数据防泄漏策略	策略类型
数据库审计策略	策略类型
数据共享接口分析策略	策略类型
数据异常访问行为分析策略	策略类型
用户操作审计策略	策略类型
其他	策略类型
技术类	策略类型
管理类	策略类型
指定库	策略范围
指定表	策略范围
当前系统	策略范围
待核查	筛选用核查状态
核查中	筛选用核查状态
已完成	筛选用核查状态
数据收集环节	管控生命周期过程域
数据传输环节	管控生命周期过程域
数据存储环节	管控生命周期过程域
数据使用环节	管控生命周期过程域
数据共享环节	管控生命周期过程域
数据销毁环节	管控生命周期过程域
敏感发现	管控策略类型
脱敏	管控策略类型
流转监测	管控策略类型
数据分级管控	管控策略类型
应用	类型
数据库	类型
身份认证	系统已具备的安全防护能力api
访问控制	系统已具备的安全防护能力api
安全网关	系统已具备的安全防护能力api
风险检测	系统已具备的安全防护能力api
敏感数据识别	系统已具备的安全防护能力api
异常行为拦截	系统已具备的安全防护能力api
其它	系统已具备的安全防护能力api
重要系统	系统标签
核心系统	系统标签
信令监测系统	系统标签
应急通令系统	系统标签
网管系统(性能管理系统)	系统类型
网管系统(资源管理系统)	系统类型
网络客服管理系统	系统类型
VOLTE信令监测系统	系统类型
7号信令监测系统	系统类型
上网日志留存系统	系统类型
垃圾短彩信管控系统	系统类型
统一DPI系统	系统类型
端局(MSC)	系统类型
HSS/HLR	系统类型
WAP网关	系统类型
关口局	系统类型
短信中心	系统类型
彩信中心(MMSC)	系统类型
行业网关	系统类型
短信网关	系统类型
LBS	系统类型
MISC(DSMP)	系统类型
其他	系统类型
生产系统	系统类型
运维系统	系统类型
管理系统	系统类型
业务支撑系统	系统类型
安全保障系统	系统类型
其他	系统类型
一级	级别
二级	级别
三级	级别
四级	级别
五级	级别
关键系统	级别
一级	级别
二级	级别
三级	级别
四极	级别
五级	级别
纺织业	纺织
纺织服装、般饰业	纺织
化学纤维制造业	纺织
结构化	结构类型
半结构化	结构类型
URL	统一检索位置
每条	统计周期
每天	统计周期
每分	统计周期
每小时	统计周期
政府	网管数据上报-接受方所属单位类型
事业单位	网管数据上报-接受方所属单位类型
企业	网管数据上报-接受方所属单位类型
个人	网管数据上报-接受方所属单位类型
移动总部	网管数据上报-接受方所属单位类型
移动专业公司、其他省公司、直属单位	网管数据上报-接受方所属单位类型
本省公司IT条线	网管数据上报-接受方所属单位类型
本省公司网络域内部其他系统	网管数据上报-接受方所属单位类型
本省公司其他条线	网管数据上报-接受方所属单位类型
其他	网管数据上报-接受方所属单位类型
工单	网管数据上报-接口开通审批方式
公文	网管数据上报-接口开通审批方式
邮件	网管数据上报-接口开通审批方式
其他审批方式	网管数据上报-接口开通审批方式
未经审批	网管数据上报-接口开通审批方式
FTP	网管数据上报-接口类型
API(WebService)	网管数据上报-接口类型
API(restful)	网管数据上报-接口类型
SFTP	网管数据上报-接口类型
旁路镜像及重定向	网管数据上报-接口类型
SDTP	网管数据上报-接口类型
Telnet	网管数据上报-接口类型
其他	网管数据上报-接口类型
UNIX主机	网管数据上报-设备类型
WIN主机	网管数据上报-设备类型
华为交换机	网管数据上报-设备类型
锐捷交换机	网管数据上报-设备类型
其他	网管数据上报-设备类型
上报任务	网管数据上报任务类型
同步任务	网管数据上报任务类型
手工添加	网管数据来源
手工导入	网管数据来源
系统同步	网管数据来源
新增	网管清单操作日志操作类型
删除	网管清单操作日志操作类型
修改	网管清单操作日志操作类型
导入	网管清单操作日志操作类型
上报状态变更	网管清单操作日志操作类型
未定级	网络安全等级保护情况
一级	网络安全等级保护情况
二级	网络安全等级保护情况
三级	网络安全等级保护情况
四级	网络安全等级保护情况
五级	网络安全等级保护情况
基础数据流程工单	考核类型
数据使用合规	考核类型
安全合规评估	考核类型
应急演练管理	考核类型
数据资产分类分级扫描	考核类型
数据安全责任管理	考核类型
数据安全风险工单	考核类型
省信安数据上报	考核类型
数据备份与恢复	考核类型
数据加密	能力类型
数据脱敏	能力类型
数据水印	能力类型
数据模糊化	能力类型
离线	能力组件状态
启用	能力组件状态
禁用	能力组件状态
数据安全管控平台	能力组件类型
应用安全网关	能力组件类型
API监测	能力组件类型
堡垒机	能力组件类型
静态脱敏系统	能力组件类型
数据库动态脱敏	能力组件类型
数据库加密	能力组件类型
数据库审计	能力组件类型
数据库防火墙	能力组件类型
文件管控	能力组件类型
网关DLP	能力组件类型
终端DLP	能力组件类型
存储	能力组件类型
分级分类	能力组件类型
API网关	能力组件类型
数据水印	能力组件类型
数据脱敏	能力组件类型
数据加密	能力组件类型
水印溯源	能力组件类型
数据识别脱敏	能力组件类型
数据库审计	能力组件类型
数据防泄露（网络DLP）	能力组件类型
接口安全管理	能力组件类型
数据库审计	能力组件类型
数据加解密	能力组件类型
静动态脱敏	能力组件类型
该资产无核查结果	脱敏策略对象验证不通过提示定义
该策略下所有资产未核查	脱敏策略对象验证不通过提示定义
静态脱敏验证分析异常	脱敏策略对象验证不通过提示定义
静态脱敏	脱敏规则
动态脱敏	脱敏规则
不通过	脱敏认证结果
通过	脱敏认证结果
未分类分级	脱敏认证结果
未验证	脱敏认证结果
执行中	脱敏验证执行状态定义
已完成	脱敏验证执行状态定义
编辑中	脱敏验证执行状态定义
未覆盖	脱敏验证策略结果定义
不通过	脱敏验证策略结果定义
验证中	脱敏验证策略结果定义
通过	脱敏验证策略结果定义
静态脱敏	脱敏验证规则定义
动态脱敏	脱敏验证规则定义
全文检索	自定义仪表盘-下钻
数字	自定义仪表盘-可使用图样
环图	自定义仪表盘-可使用图样
表格	自定义仪表盘-可使用图样
环比	自定义仪表盘-可使用图样
仪表盘	自定义仪表盘-可使用图样
雷达图	自定义仪表盘-可使用图样
柱形图	自定义仪表盘-可使用图样
折线图	自定义仪表盘-可使用图样
迁徙图	自定义仪表盘-可使用图样
省份分布	自定义仪表盘-可使用图样
Sparkline	自定义仪表盘-可使用图样
桑基图	自定义仪表盘-可使用图样
树形图	自定义仪表盘-可使用图样
世界分布	自定义仪表盘-可使用图样
趋势	自定义仪表盘-可使用图样
字符串	自定义仪表盘-字段类型
数值	自定义仪表盘-字段类型
IP	自定义仪表盘-字段类型
es	自定义仪表盘-数据库类型
mysql	自定义仪表盘-数据库类型
是	自定义仪表盘-是或者否
否	自定义仪表盘-是或者否
安徽	自定义仪表盘-省份列表
黑龙江	自定义仪表盘-省份列表
吉林	自定义仪表盘-省份列表
辽宁	自定义仪表盘-省份列表
河北	自定义仪表盘-省份列表
内蒙古	自定义仪表盘-省份列表
河南	自定义仪表盘-省份列表
山东	自定义仪表盘-省份列表
山西	自定义仪表盘-省份列表
甘肃	自定义仪表盘-省份列表
宁夏	自定义仪表盘-省份列表
新疆	自定义仪表盘-省份列表
浙江	自定义仪表盘-省份列表
江苏	自定义仪表盘-省份列表
湖北	自定义仪表盘-省份列表
湖南	自定义仪表盘-省份列表
江西	自定义仪表盘-省份列表
福建	自定义仪表盘-省份列表
广东	自定义仪表盘-省份列表
广西	自定义仪表盘-省份列表
贵州	自定义仪表盘-省份列表
西藏	自定义仪表盘-省份列表
青海	自定义仪表盘-省份列表
北京	自定义仪表盘-省份列表
天津	自定义仪表盘-省份列表
上海	自定义仪表盘-省份列表
陕西	自定义仪表盘-省份列表
重庆	自定义仪表盘-省份列表
四川	自定义仪表盘-省份列表
海南	自定义仪表盘-省份列表
云南	自定义仪表盘-省份列表
日期	自定义仪表盘-过滤方式
下拉框	自定义仪表盘-过滤方式
字符串	自定义仪表盘-过滤方式
数字	自定义仪表盘-过滤方式
IP	自定义仪表盘-过滤方式
无计算方式	自定义仪表盘-运算符
计数	自定义仪表盘-运算符
计数去重	自定义仪表盘-运算符
求和	自定义仪表盘-运算符
平均	自定义仪表盘-运算符
最大值	自定义仪表盘-运算符
最小值	自定义仪表盘-运算符
标准差	自定义仪表盘-运算符
中位数	自定义仪表盘-运算符
航空、航天器及设备制造	航空航天装备
船舶及相关装置制造	船舶及海洋工程装备
精确匹配	表名称匹配类型
正则表达式	表名称匹配类型
脱敏结果与验证规则不符	表级别验证详情不通过提示
该资产无核查结果	表级别验证详情不通过提示
该表无核查结果	表级别验证详情不通过提示
静态脱敏验证分析异常	表级别验证详情不通过提示
不包含验证规则指定分级数据	表级别验证详情通过提示字典
不足20%	覆盖比例
[20,40)	覆盖比例
[40,60)	覆盖比例
[60,80)	覆盖比例
80%及以上	覆盖比例
领域	覆盖类型
群体	覆盖类型
区域	覆盖类型
继承上级规则	规则类型
不继承	规则类型
无验证规则	规则类型
正则表达式	规则类型
关键字	规则类型
部门级	角色类型
平台级	角色类型
业务级	角色类型
一键封堵	解封账号-处置类型
账号封堵	解封账号-处置类型
bomc封堵	解封账号-处置类型
防御联动	解封账号-处置类型
锁定	解封账号-账号状态
正常	解封账号-账号状态
是	设备策略表-是否为内置策略
否	设备策略表-是否为内置策略
未关联	设备策略表关联状态
已关联	设备策略表关联状态
数据库	设备类型
主机	设备类型
正常	设备运行状态
异常	设备运行状态
字段	识别对象
内容	识别对象
备注	识别对象
正则表达式	识别方式
关键字	识别方式
系统内置	识别方式
机器学习	识别方式
用户数据	识别类型
企业数据	识别类型
A,B,C,D	识别类型列表
E,F,G,H	识别类型列表
正则表达式	识别规则类型
自然语言处理（NLP）	识别规则类型
AI	识别规则类型
列名	识别规则类型
文档指纹	识别规则类型
文件属性	识别规则类型
关键字	识别规则类型
知识库	识别规则类型
其他	识别规则类型
请求体	请求信息
请求头	请求信息
GET	请求方式
POST	请求方式
DELETE	请求方式
PUT	请求方式
HEAD	请求方式
OPTIONS	请求方式
其他	请求方式
GET	请求方法
POST	请求方法
PUT	请求方法
DELETE	请求方法
HEAD	请求方法
CONNECT	请求方法
OPTIONS	请求方法
TRACE	请求方法
增加	账号操作权限
删除	账号操作权限
修改	账号操作权限
查询	账号操作权限
创建表	账号操作权限
删除表	账号操作权限
重命名/修改表	账号操作权限
创建/删除索引	账号操作权限
执行存储过程	账号操作权限
创建/删除触发器	账号操作权限
复制	账号操作权限
导入	账号操作权限
导出	账号操作权限
可读	账号操作权限
可写	账号操作权限
可执行	账号操作权限
其他	账号操作权限
核查提醒	资产事件
内网	资产内外网
外网	资产内外网
DB2	资产协议
RDS	资产协议
TOKEN	资产协议
PRIVATE	资产协议
VNC	资产协议
FTP	资产协议
RLOGIN	资产协议
SCP	资产协议
SFTP	资产协议
X11	资产协议
X11-XDMCP	资产协议
kingbase	资产协议
oscar	资产协议
gaussdb	资产协议
greenplum	资产协议
HIVE2	资产协议
HBASE	资产协议
HDFS	资产协议
ElasticSearch	资产协议
ODPS	资产协议
MYSQL	资产协议
POSTGRESQL	资产协议
SYBASE	资产协议
INFORMIX	资产协议
MSSQ	资产协议
SSH	资产协议
TELNET	资产协议
HTTP	资产协议
DAMENG	资产协议
GBASE	资产协议
MONGODB	资产协议
TELEDB	资产协议
MARIADB	资产协议
TELEPG	资产协议
HTTPS	资产协议
RDP	资产协议
ORACLE	资产协议
TERADATA	资产协议
CLICKHOUSE	资产协议
REDIS	资产协议
FTPS	资产协议
UNKNOWN	资产协议
待认领	资产清单状态
认领不备案	资产清单状态
已备案	资产清单状态
下线	资产清单状态
白名单	资产清单状态
ACTIVE	资产状态
SILENT	资产状态
ZOMBIE	资产状态
很低	资产等级
低	资产等级
中等	资产等级
高	资产等级
很高	资产等级
APP	资产类型
DB	资产类型
FILE	资产类型
MAIL	资产类型
OTHER	资产类型
API	资产类型
IP	资产类型
ACCOUNT	资产类型
Windows Server 2000	资产类型
Windows Server 2003	资产类型
Windows Server 2008	资产类型
Windows XP	资产类型
Windows Server 2011	资产类型
Windows Server 2012	资产类型
Windows Vista	资产类型
Windows 7	资产类型
Windows 8	资产类型
Windows 10	资产类型
windows server 2019	资产类型
windows 11	资产类型
windows server 2016	资产类型
AIX	资产类型
HP-Unix	资产类型
Solaris	资产类型
Sybase	资产类型
DB2	资产类型
PostgreSQL	资产类型
Oracle	资产类型
MySQL	资产类型
Informix	资产类型
SQL Server	资产类型
DaMeng	资产类型
GBase	资产类型
MongoDB	资产类型
TeleDB	资产类型
RDS	资产类型
MariaDB	资产类型
TelePG	资产类型
人大金仓	资产类型
神州通用	资产类型
Teradata	资产类型
GaussDB	资产类型
GreenPlum	资产类型
Red Hat	资产类型
SUSE	资产类型
Ubuntu	资产类型
CentOS	资产类型
银河麒麟	资产类型
Oracle 8i	资产类型
Oracle 9i	资产类型
Oracle 10g	资产类型
Oracle 11g	资产类型
Oracle 12c	资产类型
mysql 5.5	资产类型
mysql 5.6	资产类型
mysql 5.7	资产类型
DB2 10.5	资产类型
DB2 11.5	资产类型
PostgreSQL 9.3	资产类型
PostgreSQL 10.5	资产类型
SQL Server 2000	资产类型
SQL Server 2005	资产类型
SQL Server 2008	资产类型
SQL Server 2012	资产类型
SQL Server 2014	资产类型
DaMeng 8.0	资产类型
HIVE	资产类型
HBASE	资产类型
HDFS	资产类型
ElasticSearch	资产类型
ODPS	资产类型
ClickHouse	资产类型
app	资产类型
Carbon	资产类型
CAEBON	资产类型
数据库	资产类型
API	资产类型
文件	资产类型
其他	资产类型
数管对接网域	资源池
测试资源池	资源池
株洲资源池	资源池
https://192.168.0.204:8084	资源池探针url
https://192.168.0.201:8086	资源池探针url
主机	资源类型
数据库	资源类型
铁路运输设备制造	轨道交通装备
城市轨道交通设备制造	轨道交通装备
烟草制品业	轻工
皮革、毛皮、羽毛及其制品和制鞋业	轻工
木材加工和木、竹、藤、棕、草制品业	轻工
家具制造业	轻工
造纸和纸制品业	轻工
印制和记录媒分复制业	轻工
文教、王美、体育和娱乐用品制造业	轻工
橡胶和塑料制品业	轻工
日用化学产品制造	轻工
玻璃制品制造	轻工
陶瓷制品制造	轻工
金属制日用品制造	轻工
自行车和残疾人座车制造	轻工
电池制造	轻工
家用电力器具制造	轻工
非电大家用器具制造	轻工
照明照具制造	轻工
数据库	运营数据大类
应用	运营数据大类
文件	运营数据大类
正常	运行状态
异常	运行状态
派单错误	退回原因
已处置	退回原因
数据资产	选择资产类型
对外接口	选择资产类型
应用情况	选择资产类型
基础敏感数据工单	通知发送功能模块
合规评估工单	通知发送功能模块
分类分级核查工单	通知发送功能模块
数据安全风险工单	通知发送功能模块
业务系统负责人	通知发送对象
业务系统科室安全员	通知发送对象
业务系统班组长	通知发送对象
工单派发	通知发送环节
工单填报提交	通知发送环节
工单审批	通知发送环节
首次回单提醒(前两天)	通知发送环节
首次回单提醒(前一天)	通知发送环节
首次回单提醒(当天)	通知发送环节
月底关单提醒(前两天)	通知发送环节
月底关单提醒(前一天)	通知发送环节
月底关单提醒(当天)	通知发送环节
站内信	通知选项
邮件	通知选项
短信	通知选项
SSL	通道加密情况
TLS	通道加密情况
IPSec	通道加密情况
未加密	通道加密情况
其他	通道加密情况
未加密	通道加密情况
已加密	通道加密情况
未提交	部门风险检查状态
已提交	部门风险检查状态
外部机构采集	采集阶段
数据采集合法正当	采集阶段
用户数据采集明示同意	采集阶段
停止采集	采集阶段
生产系统	重要数据清单上报-信息系统类型
运维系统	重要数据清单上报-信息系统类型
管理系统	重要数据清单上报-信息系统类型
业务支撑系统	重要数据清单上报-信息系统类型
安全保障系统	重要数据清单上报-信息系统类型
其他	重要数据清单上报-信息系统类型
互联网点对点	重要数据清单上报-数据出境方式
专线传输	重要数据清单上报-数据出境方式
VPN传输	重要数据清单上报-数据出境方式
接口调用传输	重要数据清单上报-数据出境方式
离线传输（包括但不限于：硬盘、U盘、光盘、纸质文件）	重要数据清单上报-数据出境方式
其他	重要数据清单上报-数据出境方式
收集	重要数据清单上报-数据处理使用方式
存储	重要数据清单上报-数据处理使用方式
使用	重要数据清单上报-数据处理使用方式
加工	重要数据清单上报-数据处理使用方式
传输	重要数据清单上报-数据处理使用方式
提供	重要数据清单上报-数据处理使用方式
公开	重要数据清单上报-数据处理使用方式
企业经营	重要数据清单上报-数据处理活动目的
运行维护	重要数据清单上报-数据处理活动目的
科学研究	重要数据清单上报-数据处理活动目的
监管支撑	重要数据清单上报-数据处理活动目的
其他	重要数据清单上报-数据处理活动目的
互联网点对点	重要数据清单上报-数据对外共享方式
专线传输	重要数据清单上报-数据对外共享方式
VPN传输	重要数据清单上报-数据对外共享方式
接口调用传输	重要数据清单上报-数据对外共享方式
离线传输（包括但不限于：硬盘、U盘、光盘、纸质文件）	重要数据清单上报-数据对外共享方式
其他	重要数据清单上报-数据对外共享方式
设备采集	重要数据清单上报-数据来源
设备产生	重要数据清单上报-数据来源
人工填报	重要数据清单上报-数据来源
交易购买	重要数据清单上报-数据来源
共享交互	重要数据清单上报-数据来源
其他	重要数据清单上报-数据来源
与互联网相连的信息系统	重要数据清单上报-数据载体
不与互联网相连的信息系统	重要数据清单上报-数据载体
其他电子化数据	重要数据清单上报-数据载体
非电子化数据	重要数据清单上报-数据载体
未开展网络安全等级保护认定	重要数据清单上报-网络安全等保定级情况
1级	重要数据清单上报-网络安全等保定级情况
2级	重要数据清单上报-网络安全等保定级情况
3级	重要数据清单上报-网络安全等保定级情况
4级	重要数据清单上报-网络安全等保定级情况
不足20%	重要数据清单上报-覆盖比列
[20,40)	重要数据清单上报-覆盖比列
[40,60)	重要数据清单上报-覆盖比列
[60,80)	重要数据清单上报-覆盖比列
80%及以上	重要数据清单上报-覆盖比列
领域	重要数据清单上报-覆盖类型
群体	重要数据清单上报-覆盖类型
区域	重要数据清单上报-覆盖类型
未开展通信网络安全防护定级备案	重要数据清单上报-通信网络安全防护备案
一级	重要数据清单上报-通信网络安全防护备案
二级	重要数据清单上报-通信网络安全防护备案
三级	重要数据清单上报-通信网络安全防护备案
四级	重要数据清单上报-通信网络安全防护备案
五级	重要数据清单上报-通信网络安全防护备案
第1级	重要数据等级
第2级	重要数据等级
第3级	重要数据等级
第4级	重要数据等级
DPI类	重要系统类型名称
CRM类	重要系统类型名称
话单类	重要系统类型名称
数据中台类	重要系统类型名称
4A类	重要系统类型名称
短信类	重要系统类型名称
五码类	重要系统类型名称
卡管类	重要系统类型名称
资源系统类	重要系统类型名称
定位行踪类	重要系统类型名称
网掌厅类	重要系统类型名称
投诉数据类相关系统/平台	重要系统类型名称
提供方	重要系统角色
消费方	重要系统角色
启用	金库策略当前状态
停用	金库策略当前状态
软件系统层删除	销毁-数据防护能力
存储介质层清除	销毁-数据防护能力
物理销毁	销毁-数据防护能力
数据删除	销毁阶段
介质销毁	销毁阶段
数据销毁管理要求	销毁阶段
数据销毁场景及手段	销毁阶段
数据销毁责任及用户权益保护	销毁阶段
自有流程引擎	问题处置与跟踪上报-工单来源
EOMS系统	问题处置与跟踪上报-工单来源
OA系统	问题处置与跟踪上报-工单来源
其他流程系统	问题处置与跟踪上报-工单来源
数据脱敏类	防护能力类型
数据防泄漏类	防护能力类型
数据加密类	防护能力类型
数据水印类	防护能力类型
数据库审计类	防护能力类型
数据安全网关类	防护能力类型
溯源分析类	防护能力类型
终端行为管控类	防护能力类型
其他	防护能力类型
草稿	预警处置工单状态
处理中	预警处置工单状态
已完成	预警处置工单状态
处理失败	预警处置工单状态
已归档	预警处置工单状态
已作废	预警处置工单状态
疑似超期数据	预警类型定义
非超期数据	预警类型定义
非超限数据	预警类型定义
超期数据	预警类型定义
超限数据	预警类型定义
疑似超限数据	预警类型定义
低	预警级别
中	预警级别
高	预警级别
应用资产	风险主体
数据库资产	风险主体
文件资产	风险主体
邮件资产	风险主体
其他资产	风险主体
接口	风险主体
IP	风险主体
账号	风险主体
未处理	风险事件状态
已处理	风险事件状态
合规操作偏离	风险事件类型
日均登录次数偏离	风险事件类型
合规登录偏离	风险事件类型
日均操作次数偏离	风险事件类型
日均文件下载偏离	风险事件类型
日均敏感数据操作次数偏离	风险事件类型
日均数据外发次数偏离	风险事件类型
日均外设接入次数偏离	风险事件类型
非工作日登录	风险事件类型
接口异常访问	风险事件类型
接口高频访问	风险事件类型
接口流量异常	风险事件类型
接口访问异常波动	风险事件类型
接口越权调用	风险事件类型
未备案接口	风险事件类型
接口数据未脱敏	风险事件类型
敏感数据高频访问	风险事件类型
敏感数据非工作时间访问	风险事件类型
敏感数据访问异常波动	风险事件类型
敏感数据数据未脱敏	风险事件类型
敏感数据外发	风险事件类型
敏感数据篡改	风险事件类型
敏感表访问	风险事件类型
敏感表授权行为	风险事件类型
异常登录行为	风险事件类型
异常操作行为	风险事件类型
暴力破解	风险事件类型
暴力破解成功	风险事件类型
休眠帐号登录	风险事件类型
帐号共用/借用	风险事件类型
高危命令监测	风险事件类型
高危操作监测	风险事件类型
漏扫	风险事件类型
弱口令	风险事件类型
配置核查	风险事件类型
其他	风险事件类型
低	风险事件级别
中	风险事件级别
高	风险事件级别
敏感数据识别与发现任务	风险事件级别
数据脱敏任务	风险事件级别
数据核查任务	风险事件级别
其他	风险事件级别
高频访问	风险场景名称
越权访问	风险场景名称
异常行为	风险场景名称
违规操作	风险场景名称
违规传输	风险场景名称
未纳入金库	风险场景名称
未处置	风险处置状态
已处置	风险处置状态
进行中	风险明细整改情况
已整改	风险明细整改情况
已报备-延期整改	风险明细整改情况
已报备-无法整改	风险明细整改情况
已报备-无法整改(延期整改)	风险明细整改情况
已整改(延期整改)	风险明细整改情况
未定义	风险来源
内部	风险来源
外部	风险来源
高	风险等级
中	风险等级
低	风险等级
低危	风险等级
中危	风险等级
高危	风险等级
1-1 数据爬取	风险类型
1-2 未授权导数	风险类型
2-1 高危操作	风险类型
2-2 批量删除	风险类型
2-3 批量修改	风险类型
3-1 非工作需要访问	风险类型
3-2 非工作时间访问	风险类型
3-3 未授权使用	风险类型
3-4 超范围使用数据	风险类型
3-5 未加密存储	风险类型
4-1 明文传输	风险类型
5-1.越权访问	风险类型
5-2 高频访问	风险类型
5-3 异地访问	风险类型
5-4 绕行访问	风险类型
5-5 爆破登录	风险类型
5-6 未授权访问	风险类型
5-7 未鉴权访问	风险类型
6-1 批量大文件下载	风险类型
6-2 批量下载	风险类型
6-3 复活访问	风险类型
6-4 跨境访问	风险类型
7-1 其他	风险类型
用户行为风险	风险类型
数据流转风险	风险类型
脆弱性风险	风险类型
未处置	风险运营处置状态
已处置	风险运营处置状态
忽略风险	风险运营处置状态
初验	验收类型
终验	验收类型
天	验证中
小时	验证中
天津	默认省端
POD-DEFAULT	默认资源池